AAA|Анаа|Анаа|
AAC|Аль-Ариш|Аль-Ариш|
AAH|Аахен|Аахен|
AAJ|Аварадам|Аварадам|
AAK|Аранука|Аранука|
AAL|Аальборг|Аальбург|
AAM|Мала-Мала|Мала-Мала|
AAN|Эль-Аин|Аль-Айн|
AAO|Анако|Анако|
AAQ|Витязево|Анапа|
AAR|Аарус|Аарус|
AAT|Алтай|Алтай|
AAU|Асау|Асау|
AAY|Аль-Гайда|Аль-Гайда|
ABA|Абакан|Абакан|
ABB|Абингдон|Абингдон|
ABC|Албасет|Албасет|
ABD|Абадан|Абадан|
ABF|Абайянг|Абайянг|
ABG|Абингдон|Абингдон|
ABH|Альфа|Альфа|
ABJ|Абиджан|Абиджан|
ABK|Кабри-Дар|Кабри-Дар|
ABL|Амблер|Амблер|
ABN|Альбина|Альбина|
ABP|Аткамба|Аткамба|
ABQ|Альбукерк|Альбукерк|
ABS|Абу-Симбель|Абу-Симбель|
ABV|Абуджа|Абуджа|
ABW|Абау|Абау|
ABX|Элбери|Элбери|
ABY|Олбани|Олбани|
ACC|Котока|Котока|
ACD|Аканди|Аканди|
ACE|Ланцароте|Арресиф|
ACI|Элдерни|Элдерни|
ACJ|Анурадхапура|Анурадхапура|
ACM|Арика|Арика|
ACN|Сиудад-Акуна|Сиудад-Акуна|
ACO|Аскона|Аскона|
ACR|Араракуара|Араракуара|
ACS|Ачинск|Ачинск|
ACT|Вако|Вако|
ACU|Ахутупо|Ахутупо|
ACY|Атлантик Сити|Атлантик Сити|
ACZ|Забол|Забол|
ADA|Адана|Адана|
ADB|Измир|Измир|
ADD|Аддис Абеба|Аддис Абеба|
ADE|Международный|Аден|
ADH|Алдан|Алдан|
ADJ|Амман|Амман|
ADL|Аделаида|Аделаида|
ADM|Ардмор|Ардмор|
ADN|Андес|Андес|
ADS|Даллас|Даллас|
ADT|Ада|Ада|
ADV|Эндовер|Эндовер|
ADY|Оллдейз|Оллдейз|
ADZ|Остров Сан Андрес|Остров Сан Андрес|
AEA|Абемама-Атолл|Абемама-Атолл|
AEG|Эк-Годан|Эк-Годан|
AEI|Альгесирас|Альгесирас|
AEK|Асеки|Асеки|
AEL|Альберт Ли|Альберт Ли|
AEP|Буэнос-Айрес|Буэнос-Айрес|
AER|Адлер - Сочи|Адлер|
AES|Вигра|Вигра|
AEX|Александрия международный|Александрия международный|
AEY|Акурейри|Акурейри|
AFA|Сан-Рафаэль|Сан-Рафаэль|
AFD|Порт Альфред|Порт Альфред|
AFF|Колорадо Спрингз|Колорадо Спрингз|
AFI|Амалфи|Амалфи|
AFL|Алта-Флореста|Алта-Флореста|
AFO|Афтон|Афтон|
AFR|Афоре|Афоре|
AFS|Зарафшан|Зарафшан|
AFT|Афутара|Афутара|
AFY|Афион|Афион|
AGA|Агадир Альмассира|Агадир|
AGB|Мюнхен|Мюнхен|
AGC|Питтсборо|Питтсборо|
AGD|Ангги|Ангги|
AGE|Вангерооге|Вангерооге|
AGF|Аген|Аген|
AGG|Ангорам|Ангорам|
AGI|Вагенинген|Вагенинген|
AGJ|Агуни|Агуни|
AGK|Кагуа|Кагуа|
AGL|Ванигела|Ванигела|
AGN|Ангун|Ангун|
AGP|Малага|Малага|
AGQ|Агринио|Агринио|
AGR|Агра|Агра|
AGT|Кудад-дель-Эсте|Кудад-дель-Эсте|
AGU|Агуаскалиентес|Агуаскалиентес|
AGV|Акарикуа|Акарикуа|
AGX|Агатти-Айленд|Агатти-Айленд|
AGZ|Аггенейз|Аггенейз|
AHA|Окинава|Окинава|
AHB|Абха|Абха|
AHD|Ардмор|Ардмор|
AHI|Амахаи|Амахаи|
AHL|Аисхалтон|Аисхалтон|
AHN|Афины|Афины|
AHS|Ахуас|Ахуас|
AHT|Ам-Тиман|Ам-Тиман|
AHY|Амбатолахи|Амбатолахи|
AIA|Альянс|Альянс|
AIB|Анита Бэй|Анита Бэй|
AIC|Айрок|Айрок|
AIE|Айоме|Айоме|
AIG|Ялинга|Ялинга|
AIL|Айлиганди|Айлиганди|
AIS|Ароре-Айленд|Ароре-Айленд|
AIT|Аитутаки|Аитутаки|
AIY|Атлантик Сити|Атлантик Сити|
AJA|Кампо Дель Оро|Аяччио|
AJF|Джуф|Джуф|
AJI|Агри|Агри|
AJJ|Акжужт|Акжужт|
AJL|Айзаул|Айзаул|
AJN|Анжуан|Анжуан|
AJO|Альюф|Альюф|
AJR|Арвидсьяур|Арвидсьяур|
AJS|Абреохос|Абреохос|
AJU|Санта Мария|Аракайю|
AKA|Анькан|Анькан|
AKD|Акола|Акола|
AKE|Акиени|Акиени|
AKF|Куфра|Куфра|
AKG|Ангуганак|Ангуганак|
AKJ|Асахикава|Асахикава|
AKL|Окленд|Окленд|
AKM|Закума|Закума|
AKO|Akron|Akron|
AKQ|Астраксетра|Астраксетра|
AKR|Акере|Акере|
AKT|Акротири|Акротири|
AKU|Аксу|Аксу|
AKX|Актюбинск|Актюбинск|
ALA|Алматы|Алматы|
ALB|Олбани международный|Олбани|
ALC|Аликанте|Аликанте|
ALD|Алерта|Алерта|
ALF|Альта|Алта|
ALH|Олбани|Олбани|
ALJ|Кортдум|Александер-Бей|
ALK|Асела|Асела|
ALL|Албенга|Албенга|
ALM|Аламогордо|Аламогордо|
ALN|Альтон|Альтон|
ALO|Ватерло|Ватерло|
ALP|Алеппо|Алеппо|
ALR|Александра|Александра|
ALS|Аламоса|Аламоса|
ALU|Алула|Алула|
ALV|Андорра-ла-Велла|Андорра-ла-Велла|
ALY|Александрия|Александрия|
AMB|Амбилобе|Амбилобе|
AMD|Ахмедабад|Ахмедабад|
AME|Альто-Молокуэ|Альто-Молокуэ|
AMF|Ама|Ама|
AMH|Арба-Минч|Арба-Минч|
AMJ|Альменара|Альменара|
AMK|Дуранго|Дуранго|
AMM|Амман|Амман|
AMO|Мао|Мао|
AMP|Ампанихи|Ампанихи|
AMQ|Амбон|Амбон|
AMR|Арно|Арно|
AMS|Амстердам|Амстердам|
AMT|Амата|Амата|
AMU|Аманаб|Аманаб|
AMV|Амдерма|Амдерма|
AMW|Амес|Амес|
AMY|Амбатомаинти|Амбатомаинти|
AMZ|Ардмор|Ардмор|
ANA|Анахайм|Анахайм|
ANC|Анкораж|Анкораж|
AND|Андерсон|Андерсон|
ANE|Анжер|Анжер|
ANF|Антофагаста|Антофагаста|
ANG|Ангулем|Ангулем|
ANJ|Занага|Занага|
ANK|Анкара|Анкара|
ANL|Андуло|Андуло|
ANM|Антсирабато|Анталаха|
ANP|Ли|Аннаполис|
ANQ|Ангола|Ангола|
ANR|Антверпен|Антверпен|
ANS|Андауайлас|Андауайлас|
ANX|Анденес|Анденес|
AOA|Ароа|Ароа|
AOB|Аннаберг|Аннаберг|
AOC|Альтенбург|Альтенбург|
AOD|Абу-Дейя|Абу-Дейя|
AOE|Эскишехир|Эскишехир|
AOG|Аншан|Аньшань|
AOH|Лима|Лима|
AOI|Анкона|Анкона|
AOJ|Аомори|Аомори|
AOK|Карпатос|Карпатос|
AON|Арона|Арона|
AOO|Мартинсбург|Мартинсбург|
AOR|Алор-Сетар|Алор-Сетар|
AOT|Аоста|Аоста|
AOU|Аттопью|Аттопью|
APA|Денвер|Денвер|
APB|Аполо|Аполо|
APC|Напа|Напа|
APE|Сан-Хуан-Апосенто|Сан-Хуан-Апосенто|
APF|Неаполь|Неаполь|
API|Апиай|Апиай|
APL|Нампула|Нампула|
APO|Апартадо|Апартадо|
APP|Асапа|Асапа|
APR|Эйприл-Ривер|Эйприл-Ривер|
APS|Анаполис|Анаполис|
APT|Джаспер|Джаспер|
APV|Эппл Вэлли|Эппл Вэлли|
APZ|Запала|Запала|
AQG|Аньцин|Аньцин|
AQI|Кайсумах|Кайсумах|
AQJ|Акаба|Акаба|
AQP|Арекуипа|Арекуипа|
AQS|Сакани|Сакани|
ARD|Алор-Айленд|Алор-Айленд|
ARH|Талаги|Архангельск|
ARI|Арика|Арика|
ARJ|Арсо|Арсо|
ARK|Аруша|Аруша|
ARL|Арли|Арли|
ARM|Армидаль|Армидаль|
ARN|Стокгольм|Стокгольм|
ARO|Арболетас|Арболетас|
ARP|Араджип|Араджип|
ARQ|Араукита|Араукита|
ARR|Альто-Рио-Сенгерр|Альто-Рио-Сенгерр|
ARW|Арад|Арад|
ASA|Ассаб|Ассаб|
ASB|Ашхабад|Ашхабад|
ASC|Аскеншн|Аскеншн|
ASE|Аспен|Аспен|
ASF|Астрахань|Астрахань|
ASG|Ашбертон|Ашбертон|
ASJ|Амами-О-Сима|Амами-О-Сима|
ASL|Маршалл|Маршалл|
ASN|Талладега|Талладега|
ASO|Асоса|Асоса|
ASP|Элис Спрингз|Элис Спрингз|
ASQ|Остин|Остин|
ASR|Кайсери|Кайсери|
ASU|Асунсьон|Асунсьон|
ASV|Амбосели|Амбосели|
ASW|Асуан|Асуан|
ASX|Эшленд|Эшленд|
ASZ|Асирим|Асирим|
ATA|Анта|Анта|
ATB|Атбара|Атбара|
ATD|Атоифи|Атоифи|
ATF|Амбато|Амбато|
ATH|Афины|Афины|
ATI|Артигас|Артигас|
ATJ|Анцирабе|Анцирабе|
ATM|Альтамира|Альтамира|
ATN|Наматанай|Наматанай|
ATO|Афины|Афины|
ATP|Айтейп|Айтейп|
ATQ|Амритсар|Амритсар|
ATR|Атар|Атар|
ATV|Ати|Ати|
ATW|Эпплтон|Эпплтон|
ATX|Атбасар|Атбасар|
ATZ|Асьют|Асьют|
AUC|Араука|Араука|
AUH|Абу-Даби|Абу-Даби|
AUJ|Амбунти|Амбунти|
AUM|Остин|Остин|
AUN|Обурн|Обурн|
AUO|Обурн|Обурн|
AUP|Агаун|Агаун|
AUR|Орийак|Орийак|
AUT|Атауро|Атауро|
AUY|Анейтьюм|Анейтьюм|
AVB|Авиано|Авиано|
AVF|Авориаз|Аворьяз|
AVG|Овернь|Овернь|
AVN|Авиньон|Авиньон|
AVU|Аву-Аву|Аву-Аву|
AVV|Мельбурн-аэропорт Авалон|Гелонг|
AVW|Туксон|Туксон|
AWA|Авасса|Авасса|
AWB|Аваба|Аваба|
AWD|Анива|Анива|
AWE|Алове|Алове|
AWH|Аварех|Аварех|
AWR|Авар|Авар|
AWZ|Ахваз|Ахваз|
AXB|Александрия Бэй|Александрия Бэй|
AXD|Димокритос|Александрополи|
AXG|Алгона|Алгона|
AXK|Атак|Атак|
AXL|Александрия|Александрия|
AXM|Армения|Армения|
AXN|Александрия|Александрия|
AXT|Акита|Акита|
AXU|Аксум|Аксум|
AYA|Айапел|Айапел|
AYC|Айакучо|Аякучо|
AYG|Ягуара|Ягуара|
AYI|Яри|Яри|
AYK|Аркалык|Аркалык|
AYN|Аньян|Аньян|
AYP|Аякучо|Аякучо|
AYQ|Айерс Рок|Айерс Рок|
AYR|Эйр|Эйр|
AYT|Анталия|Анталия|
AYU|Айюра|Айюра|
AYW|Аяваси|Аяваси|
AZB|Амазон-Бей|Амазон-Бей|
AZD|Язд|Язд|
AZG|Апацинган|Апацинган|
AZI|Батин|Абу-Даби|
AZN|Андижан|Андижан|
AZO|Каламазу|Каламазу|
AZP|Мексико Сити|Мексико Сити|
AZR|Адрар|Адрар|
AZT|Запатока|Запатока|
BAA|Биалла|Биалла|
BAD|Шревспорт|Шревспорт|
BAE|Барселонетта|Барселонетта|
BAG|Багуйо|Багуйо|
BAI|Буэнос-Айрес|Буэнос-Айрес|
BAJ|о.Бали|Бали|
BAN|Базонго|Базонго|
BAP|Байбара|Байбара|
BAQ|Барранкуилла|Барранкуилла|
BAR|Бейкер-Айленд, шт. Аляска|Бейкер-Айленд, шт. Аляска|
BAS|Балале|Балале|
BAV|Баотоу|Баотоу|
BAW|Биавонке|Биавонке|
BAX|Барнаул|Барнаул|
BAY|Байя Маре|Байя Маре|
BBA|Балмаседа|Балмаседа|
BBC|Бэй Сити|Бэй Сити|
BBG|Бутаритари|Бутаритари|
BBH|Барт|Барт|
BBI|Бхубанесвар|Бхубанесвар|
BBJ|Битбург|Битбург|
BBK|Касане|Касане|
BBL|Баболсар|Баболсар|
BBM|Баттамбанг|Баттамбанг|
BBO|Бербера|Бербера|
BBT|Берберати|Берберати|
BBU|Бухарест|Бухарест|
BBY|Бамбари|Бамбари|
BBZ|Замбези|Замбези|
BCA|Баракоа|Баракоа|
BCD|Баколод|Баколод|
BCF|Бука|Бука|
BCG|Бемичи|Бемичи|
BCH|Баукау|Баукау|
BCL|Барра-Колорадо|Барра-Колорадо|
BCM|Бакау|Бакэу|
BCN|Барселона|Барселона|
BCQ|Вейл-Игл, шт. Колорадо|Вейл-Игл, шт. Колорадо|
BCT|Бока Ратон|Бока Ратон|
BCU|Баучи|Баучи|
BCX|Белорецк|Белорецк|
BCY|Бульчи|Бульчи|
BDB|Бандаберг|Бандаберг|
BDH|Бандар-Ленге|Бандар-Ленге|
BDI|Берд-Айленд|Берд-Айленд|
BDJ|Банджармасин|Банджармасин|
BDM|Бандирма|Бандирма|
BDN|Бадин|Бадин|
BDO|Бандунг|Бандунг|
BDP|Бхадрапур|Бхадрапур|
BDS|Бриндиси|Бриндиси|
BDT|Гбадолите|Гбадолите|
BDU|Бордуфос|Бордуфос|
BDV|Моба|Моба|
BDZ|Байндунг|Байндунг|
BEA|Берейна|Берейна|
BEC|Вичита|Вичита|
BEF|Блуфилдс|Блуфилдс|
BEG|Белград|Белград|
BEH|Бентон Харбор|Бентон Харбор|
BEI|Бейка|Бейка|
BEL|Белем|Белем|
BEM|Боссембеле|Боссембеле|
BEO|Ньюкасл|Ньюкасл|
BEP|Беллари|Беллари|
BER|Берлин|Берлин|
BES|Брест|Брест|
BEW|Бейра|Бейра|
BEY|Бейрут|Бейрут|
BEZ|Беру|Беру|
BFE|Билифельд|Билефельд|
BFH|Куритиба|Куритиба|
BFI|Сиэттл|Сиэттл|
BFJ|Ба|Ба|
BFL|Бейкерсфилд|Бейкерсфилд|
BFM|Мобайл|Мобайл|
BFU|Бенгбу|Бенгбу|
BGC|Браганса|Браганса|
BGH|Боге|Боге|
BGK|Биг-Крик|Биг-Крик|
BGL|Баглунг|Баглунг|
BGO|Берген|Берген|
BGP|Бонго|Бонго|
BGR|Бангор|Бангор|
BGU|Бангассу|Бангассу|
BGW|Багдад|Багдад|
BGY|Бергамо|Бергамо|
BGZ|Брага|Брага|
BHB|Бар Харбор|Бар Харбор|
BHE|Бленхайм|Бленхайм|
BHF|Бахья-Купика|Бахья-Купика|
BHG|Брюс-Лагуна|Брюс-Лагуна|
BHH|Биша|Биша|
BHJ|Бхудж|Бхудж|
BHK|Бухара|Бухара|
BHL|Бахиа-Ангелес|Бахиа-Ангелес|
BHN|Бейхан|Бейхан|
BHO|Бхопал|Бхопал|
BHP|Бхойпур|Бхойпур|
BHR|Бхаратпур|Бхаратпур|
BHS|Батерст|Батерст|
BHU|Бхавнагар|Бхавнагар|
BHV|Бахавалпур|Бахавалпур|
BHW|Саргодха|Саргодха|
BHY|Бэйхай|Бейхай|
BIA|Бастия|Бастия|
BIB|Байдоа|Байдоа|
BIC|Биг-Крик|Биг-Крик|
BIF|Эль Пасо|Эль Пасо|
BIH|Бишоп|Бишоп|
BII|Бикини-Атолл|Бикини-Атолл|
BIL|Биллингс|Биллингс|
BIN|Бамиан|Бамиан|
BIO|Билбао|Билбао|
BIQ|Биарриц|Биарриц|
BIR|Биратнагар|Биратнагар|
BIS|Бисмарк|Бисмарк|
BIT|Байтади|Байтади|
BIU|Билдудалур|Билдудалур|
BIV|Бриа|Бриа|
BIY|Бишо|Бишо|
BIZ|Бимин|Бимин|
BJD|Баккафьордур|Баккафьордур|
BJF|Ботсфьорд|Ботсфьорд|
BJG|Болаанг|Болаанг|
BJH|Баджханг|Баджханг|
BJJ|Вустер|Вустер|
BJK|Бенджина|Бенджина|
BJN|Бахоне|Бахоне|
BJO|Бермехо|Бермехо|
BJR|Бахар-Дар|Бахар-Дар|
BJU|Баджура|Баджура|
BJV|Бодрум|Бодрум|
BJW|Баджава|Баджава|
BJY|Белград|Белград|
BJZ|Бадахос|Бадахос|
BKA|Быково|Москва|
BKB|Биканер|Биканер|
BKJ|Боке|Боке|
BKK|Бангкок|Бангкок|
BKR|Бокоро|Бокоро|
BKS|Бенгкулу|Бенгкулу|
BKY|Кавуму|Кавуму|
BKZ|Букоба|Букоба|
BLA|Барселона|Барселона|
BLB|Балбоа|Балбоа|
BLC|Бали|Бали|
BLE|Борланг|Борланг|
BLJ|Батна|Батна|
BLL|Биллунд|Биллунд|
BLP|Беллависта|Беллависта|
BLQ|Болонья|Болонья|
BLR|Бангалор|Бангалор|
BLV|Белльвиль|Белльвиль|
BLX|Беллуно|Беллуно|
BLY|Белмаллет|Белмаллет|
BMA|Стокгольм|Стокгольм|
BMB|Бумба|Бумба|
BMD|Бело|Бело|
BME|Брум|Брум|
BMF|Бакума|Бакума|
BMH|Бомай|Бомай|
BMJ|Барамита|Барамита|
BMK|Боркум|Боркум|
BML|Берлинский муниципальный аэропорт|Берлин|
BMM|Битам|Битам|
BMN|Бамерни|Бамерни|
BMO|Бамо|Бамо|
BMP|Бремптон Айленд|Бремптон Айленд|
BMQ|Бамбури|Бамбури|
BMR|Балтрум|Балтрум|
BMT|Бомонт Муни|Бомонт Муни|
BMU|Бима|Бима|
BMW|Борж-Бажи-Мохтар|Борж-Бажи-Мохтар|
BMZ|Баму|Баму|
BNB|Боэнде|Боэнде|
BNC|Бени|Бени|
BND|Бандар-Аббас|Бандар-Аббас|
BNE|Брисбан|Брисбан|
BNH|Хартфорд|Хартфорд|
BNI|Бенин-Сити|Бенин-Сити|
BNK|Баллина|Баллина|
BNM|Бодинуму|Бодинуму|
BNN|Броннойзунд|Броннойзунд|
BNP|Банну|Банну|
BNR|Банфора|Банфора|
BNS|Баринас|Баринас|
BNT|Бунди|Бунди|
BNU|Блюменау|Блюменау|
BNV|Боана|Боана|
BNX|Баня-Лука|Баня-Лука|
BNY|Беллона|Беллона|
BNZ|Банц|Банц|
BOA|Бома|Бома|
BOD|Бордо|Бордо|
BOE|Бунджи|Бунджи|
BOG|Богота|Богота|
BOJ|Бургас|Бургас|
BOO|Бодо|Бодо|
BOP|Буар|Буар|
BOQ|Боку|Боку|
BOR|Белфорт|Белфорт|
BOS|Бостон|Бостон|
BOU|Борже|Борже|
BOV|Боанг|Боанг|
BOY|Борго|Борго|
BOZ|Бозум|Бозум|
BPB|Бориди|Бориди|
BPD|Бапи|Бапи|
BPE|Баган|Баган|
BPH|Бислиг|Бислиг|
BPN|Баликпапан|Баликпапан|
BPS|Порто Сегуро|Порто Сегуро|
BPU|Беппу|Беппу|
BPY|Бесалампи|Бесалампи|
BQA|Балер|Балер|
BQE|Бубаку|Бубаку|
BQS|Игнатьево|Благовещенск|
BQT|Брест|Брест|
BRE|Бремен|Бремен|
BRH|Брахман|Брахман|
BRI|Бари|Бари|
BRM|Баркисимето|Баркисимето|
BRN|Берне|Берне|
BRP|Биару|Биару|
BRQ|Брно|Брно|
BRR|Норт Бэй|Норт Бэй|
BRS|Бристоль|Бристоль|
BRU|Аэропорт Брюсселя|Брюссель|
BRV|Бременхавен|Бременхавен|
BRX|Барахона|Барахона|
BSA|Боссасо|Боссасо|
BSB|Бразилия|Бразилия|
BSC|Бахья-Солано|Бахья-Солано|
BSD|Баошань|Баошань|
BSE|Семантан|Семантан|
BSG|Бата|Бата|
BSK|Бискра|Бискра|
BSN|Боссанга|Боссанга|
BSO|Баско|Баско|
BSP|Бенсбах|Бенсбах|
BST|Бост|Бост|
BSU|Базанкусу|Базанкусу|
BSX|Бассейн|Бассейн|
BSY|Бардера|Бардера|
BTB|Бету|Бету|
BTE|Бонте|Бонте|
BTG|Батангафо|Батангафо|
BTJ|Банда Асе|Банда Асе|
BTK|Братск|Братск|
BTO|Ботопасье|Ботопасье|
BTQ|Бутаре|Бутаре|
BTR|Батон Руж|Батон Руж|
BTS|Братислава|Братислава|
BTU|Бинтулу|Бинтулу|
BTW|Бату-Личин|Бату-Личин|
BTZ|Бурса|Бурса|
BUD|Будапешт|Будапешт|
BUG|Бенгела|Бенгела|
BUI|Бокондини|Бокондини|
BUK|Альбук|Альбук|
BUL|Булоло|Булоло|
BUN|Буэнавентура|Буэнавентура|
BUO|Бурао|Бурао|
BUP|Бхатинда|Бхатинда|
BUQ|Булавайо|Булауайо|
BUR|Бурбанк|Бурбанк|
BUS|Батуми|Батуми|
BUT|Бертонвуд|Бертонвуд|
BUV|Белла-Юнион|Белла-Юнион|
BUX|Буниа|Буниа|
BUY|Банбери|Банбери|
BUZ|Бушехр|Бушехр|
BVA|Париж|Париж|
BVE|Брив-ла-Гайард|Брив-ла-Гайард|
BVF|Буа|Буа|
BVG|Берлевог|Берлевог|
BVI|Бирдсвилл|Бирдсвилл|
BVM|Бельмонте|Бельмонте|
BVP|Боловип|Боловип|
BWA|Бхайрава|Бхайрава|
BWE|Брауншвайг|Брауншвайг|
BWH|Баттерворт|Баттерворт|
BWJ|Баван|Баван|
BWK|Бол|Бол|
BWN|Бандар Сери Бегаван|Бандар Сери Бегаван|
BWO|Балаково|Балаково|
BWU|Сидней|Сидней|
BWY|Вудбридж|Вудбридж|
BXB|Бабо|Бабо|
BXD|Баде|Баде|
BXE|Бакель|Бакель|
BXG|Бендиго|Бендиго|
BXH|Балхаш|Балхаш|
BXJ|Бурундай|Бурундай|
BXL|Блю-Лагун|Блю-Лагун|
BXM|Батом|Батом|
BXN|Бодрум|Бодрум|
BXO|Буокс|Буокс|
BXT|Бонтанг|Бонтанг|
BXU|Бутуан|Бутуань|
BYB|Дибаа|Дибаа|
BYC|Якуйба|Якуйба|
BYD|Бейда|Бейда|
BYL|Белла-Елла|Белла-Елла|
BYM|Байамо|Байамо|
BYQ|Бунью|Бунью|
BYT|Бантри|Бантри|
BYU|Байройт|Байройт|
BZA|Сан-Педро|Бонанса|
BZC|Бузиос|Бузиос|
BZG|Быдгощ|Быдгощ|
BZI|Балыкесир|Балыкесир|
BZK|Брянск|Брянск|
BZL|Барисал|Барисал|
BZM|Вонсдрехт|Берген Оп Зоом|
BZO|Болзано|Болзано|
BZR|Безьер|Безьер|
BZY|Бельцы|Бельцы|
BZZ|Оксфорд|Оксфорд|
CAA|Катакамас|Катакамас|
CAB|Кабинда|Кабинда|
CAG|Кальяри|Кальяри|
CAH|Ка-Мау|Ка-Мау|
CAI|Каир|Каир|
CAJ|Канайма|Канайма|
CAL|Кемпбелтаун|Кемпбелтаун|
CAM|Камири|Камири|
CAN|Гуанчжоу|Гуанчжоу|
CAP|Кеп-Гаитиен|Кеп-Гаитиен|
CAQ|Каукасиа|Каукасиа|
CAS|Касабланка|Касабланка|
CAT|Кэт-Айленд|Кэт-Айленд|
CAV|Казомбо|Казомбо|
CAX|Карлисл|Карлисл|
CBB|Качабамба|Качабамба|
CBD|Кар-Никобар|Кар-Никобар|
CBG|Кембридж|Кембрдидж|
CBJ|Кабо-Рожо|Кабо-Рожо|
CBL|Сьюдад-Боливар|Сьюдад-Боливар|
CBN|Чиребон|Чиребон|
CBO|Котабато|Котабато|
CBP|Коимбра|Коимбра|
CBQ|Калабар|Калабар|
CBR|Канберра|Канберра|
CBS|Кабимас|Кабимас|
CBU|Коттбус|Коттбус|
CBV|Кобан|Кобан|
CCC|Кайо Коко|Кайо Коко|
CCD|Лос Анджелес|Лос Анджелес|
CCF|Каркассон|Каркассон|
CCH|Чиле-Чико|Чиле-Чико|
CCL|Шиншилла|Шиншилла|
CCN|Чагчаран|Чагчаран|
CCO|Каримагуа|Каримагуа|
CCP|Консепсьон|Консепсьон|
CCS|Каракас|Каракас|
CCT|Колония-Катриэль|Колония-Катриэль|
CCV|Крейг-Кав|Крейг-Кав|
CCX|Касерес|Касерес|
CDA|Куинда|Куинда|
CDC|Сидар Сити|Сидар Сити|
CDE|Каледония|Каледония|
CDG|Париж|Париж|
CDO|Крадок|Крадок|
CDP|Куддапах|Куддапах|
CDS|Чайлдресс|Чайлдресс|
CDZ|Кадиз|Кадиз|
CEA|Вичита|Вичита|
CEB|Кебу|Кебу|
CEE|Череповец|Череповец|
CEG|Честер|Честер|
CEI|Чанг-Рай|Чанг-Рай|
CEJ|Чернигов|Чернигов|
CEK|Челябинск|Челябинск|
CEL|Кейп-Элутера|Кейп-Элутера|
CEN|Сиудад-Обрегон|Сиудад-Обрегон|
CEO|Вако-Кунго|Вако-Кунго|
CEP|Консепсион|Консепсьон|
CEQ|Канны|Канны|
CER|Шербург|Шербург|
CET|Шоле|Шоле|
CEZ|Кортез|Кортез|
CFE|Клермон-Ферран|Клермон-Ферран|
CFG|Сьенфуэгос|Сиенфуэгос|
CFN|Донегаль|Донегаль|
CFO|Конфреца|Конфреца|
CFR|Кан|Кан|
CFS|Коффс Харбор|Коффс Харбор|
CGB|Куиаба|Куиаба|
CGC|Кейп-Глусестер|Кейп-Глусестер|
CGD|Чандэ|Чандэ|
CGE|Кембридж|Кембрдидж|
CGG|Касигуран|Касигуран|
CGH|Сао Паоло|Сао Паоло|
CGJ|Чингола|Чингола|
CGM|Камигуин|Камигуин|
CGN|Кельн|Кельн|
CGO|Женьчжоу|Чженчжоу|
CGQ|Чангчун|Чаньчунь|
CGR|Кампо Гранде|Кампо Гранде|
CGS|Колледж парк|Колледж парк|
CGT|Шингитти|Шингитти|
CGU|Сьюдад-Гуаяна|Сьюдад-Гуаяна|
CGX|Чикаго|Чикаго|
CGY|Кагаян Де Оро|Кагаян Де Оро|
CHB|Чилас|Чилас|
CHC|Кристчерч|Кристчерч|
CHD|Меса|Меса|
CHG|Чаоян|Чаоян|
CHH|Чачапояс|Чачапояс|
CHI|Чикаго|Чикаго|
CHM|Чимботе|Чимботе|
CHN|Джеонжу|Джеонжу|
CHO|Шарлоттсвилль|Шарлоттсвилль|
CHR|Шаторуа|Шаторуа|
CHT|Чатам-Айленд|Чатам-Айленд|
CHV|Чавес|Чавес|
CHX|Чангвинола|Чангвинола|
CHY|Чойсфул-Бей|Чойсфул-Бей|
CIA|Кьямпино|Рим|
CIF|Чифен|Чифен|
CIH|Чанжи|Чанжи|
CIJ|Кобиха|Кобиха|
CIM|Кимитарра|Кимитарра|
CIO|Консепсьон|Консепсьон|
CIP|Чипата|Чипата|
CIQ|Чикумула|Чикумула|
CIR|Каир|Каир|
CIS|Кентон-Айленд|Кентон-Айленд|
CIT|Шимкент|Шимкент|
CIU|Со Сен Мари|Со Сен Мари|
CIX|Чиклайо|Чиклайо|
CIY|Комизо|Комизо|
CJA|Кахамарка|Кахамарка|
CJB|Коимбаторе|Коимбаторе|
CJC|Калама|Калама|
CJD|Кандилежас|Кандилежас|
CJI|Сиудад Реаль|Сиудад Реаль|
CJL|Читрал|Читрал|
CJM|Чампхон|Чампхон|
CJS|Сиудад Хуарез|Сиудад Хуарез|
CKA|Чероки|Чероки|
CKC|Черкассы|Черкассы|
CKG|Чонсинь|Чонсинь|
CKH|Чокурдах|Чокурдах|
CKK|Чероки|Чероки|
CKL|Чкаловский|Чкаловский|
CKV|Кларксвилл|Кларксвилл|
CKZ|Канаккале|Канаккале|
CLA|Комилла|Комилла|
CLB|Кестлбар|Кастлбар|
CLJ|Клуж-Напока|Клуж-Напока|
CLM|Порт Анжелес|Порт Анжелес|
CLO|Кали|Кали|
CLQ|Колима|Колима|
CLT|Шарлотт|Шарлотт|
CLW|Клируотер|Клируотер|
CLX|Клоринда|Клоринда|
CLY|Кальви|Кальви|
CLZ|Калабосо|Калабосо|
CMB|Коломбо|Коломбо|
CMF|Шамбери|Шамбери|
CMM|Кармелита|Кармелита|
CMN|Касабланка|Касабланка|
CMO|Оббиа|Оббиа|
CMR|Колмар|Колмар|
CMS|Скускубан|Скускубан|
CMT|Камета|Камета|
CMV|Коромандель|Коромандель|
CMW|Камагуэй|Камагуэй|
CMX|Хэнкок|Хэнкок|
CMY|Спарта|Спарта|
CNA|Кананеа|Кананеа|
CND|Константа|Константа|
CNG|Коньяк|Коньяк|
CNL|Зиндаль|Зиндаль|
CNN|Чульман|Чульман|
CNQ|Корриентес|Корриентес|
CNR|Чаньяраль|Чаньяраль|
CNS|Кернс|Кернс|
CNT|Чарата|Чарата|
CNX|Чанг-Май|Чанг-Май|
CNY|Моаб|Моаб|
CNZ|Кангамба|Кангамба|
COA|Колумбия|Колумбия|
COG|Кондото|Кондото|
COH|Куч-Бехар|Куч-Бехар|
COK|Кочи|Кочи|
COR|Кордова|Кордова|
COS|Колорадо Спрингз|Колорадо Спрингз|
COU|Колумбия|Колумбия|
COV|Ковилья|Ковилья|
COW|Кокимбо|Кокимбо|
COX|Конго-Таун|Конго-Таун|
COZ|Констанца|Констанца|
CPA|Кейп-Палмас|Кейп-Палмас|
CPB|Капургана|Капургана|
CPD|Кубер Педи|Кубер Педи|
CPE|Кампеше|Кампеше|
CPF|Чепу|Чепу|
CPH|Копенгаген|Копенгаген|
CPL|Чапаррал|Чапаррал|
CPO|Копьяпо|Копьяпо|
CPQ|Кампинас|Кампинас|
CPT|Кейптаун|Кейптаун|
CQF|Кале|Кале|
CQP|Кейп-Флеттери|Кейп-Флеттери|
CQT|Какуэтаниа|Какуэтаниа|
CRA|Крайова|Крайова|
CRC|Картаго|Картаго|
CRE|Миртл Бич|Миртл Бич|
CRF|Карнот|Карнот|
CRJ|Курабье|Курабье|
CRL|Брюссель|Брюссель|
CRM|Катарман|Катарман|
CRN|Кромарти|Кромарти|
CRQ|Каравелас|Каравелас|
CRR|Керес|Керес|
CRV|Кротоне|Кротон|
CRX|Коринт|Коринт|
CSB|Карансебеш|Карансебеш|
CSC|Канас|Канас|
CSH|Соловки|Соловецкий|
CSI|Давид|Феникс|
CSK|Кеп-Скирринг|Кеп-Скирринг|
CSR|Касуарито|Касуарито|
CST|Кастэвей|Кастэвей|
CSX|Чангша|Чанша|
CSY|Чебоксары|Чебоксары|
CTA|Катания|Катания|
CTC|Катамарка|Катамарка|
CTE|Карти|Карти|
CTG|Картегена|Картегена|
CTI|Куито|Куито|
CTM|Четумал|Четумал|
CTN|Куктаун|Куктаун|
CTR|Кэттл-Крик|Кэттл-Крик|
CTS|Саппоро|Саппоро|
CTT|Ле-Кастейе|Ле-Кастейе|
CTU|Ченгду|Ченгду|
CUA|Сиудад-Конститусьон|Сиудад-Конститусьон|
CUB|Колумбия|Колумбия|
CUD|Калундра|Калундра|
CUE|Куенка|Куенка|
CUF|Кунео|Кунео|
CUI|Куррилло|Куррилло|
CUJ|Кулион|Кулион|
CUM|Кумана|Кумана|
CUN|Канкун|Канкун|
CUO|Каруру|Каруру|
CUP|Карупано|Карупано|
CUU|Чихуахуа|Чихуахуа|
CUX|Корпус Кристи|Корпус Кристи|
CUZ|Куско|Куско|
CVA|Питтсборо|Питтсборо|
CVE|Ковенас|Ковенас|
CVF|Куршевель|Куршевель|
CVH|Кавиахуэ|Кавиахуэ|
CVI|Калета-Оливия|Калета-Оливия|
CVJ|Куернавака|Куернавака|
CVL|Кейп-Вогель|Кейп-Вогель|
CVM|Сиудад-Виктория|Сиудад-Виктория|
CVO|Олбани|Олбани|
CWB|Куритиба|Куритиба|
CWC|Черновцы|Черновцы|
CWP|Кампбеллпур|Кампбеллпур|
CXH|Ванкувер|Ванкувер|
CXJ|Касьяс ду Суль|Касьяс ду Суль|
CXN|Кандала|Кандала|
CXR|Нха Транг|Нха Транг|
CYA|Лес-Кейес|Лес-Кейес|
CYC|Кайе-Чапел|Кайе-Чапел|
CYI|Чиайи|Чиайи|
CYL|Койолес|Койолес|
CYO|Кайо Ларго Дель Сур|Кайо Ларго Дель Сур|
CYP|Калбайог|Калбайог|
CYR|Колония|Колония|
CYS|Чейнни|Чейнни|
CYX|Якут|Черский|
CYZ|Кауаян|Кауаян|
CZA|Чинчен Ица|Чинчен Ица|
CZE|Коро|Коро|
CZH|Коросал|Корозал|
CZM|Коцумел|Коцумел|
CZU|Коросал|Корозал|
CZW|Честокова|Щесточова|
CZX|Чангзу|Чангзу|
DAB|Дайтона Бич|Дайтона Бич|
DAD|Да-Нанг|Да-Нанг|
DAE|Дапаризо|Дапаризо|
DAF|Доп|Доп|
DAH|Датина|Датина|
DAI|Дарджилинг|Дарцзилин|
DAL|Даллас|Даллас|
DAM|Дамаск|Дамаск|
DAP|Дарчула|Дарчула|
DAT|Датон|Датонг|
DAU|Дару|Дару|
DAV|Давид|Давид|
DAX|Дэцзян|Дэцзян|
DAZ|Дарваз|Дарваз|
DBA|Далбандин|Далбандин|
DBD|Дханбад|Дханбад|
DBM|Дебра-Маркос|Дебра-Маркос|
DBN|Дублин|Дублин|
DBO|Дуббо|Дуббо|
DBQ|Дюбюк|Дюбюк|
DBT|Дебра-Табор|Дебра-Табор|
DBV|Дубровник|Дубровник|
DCM|Кастре|Кастре|
DDG|Дандун|Даньдон|
DDM|Додоима|Додоима|
DDU|Даду|Даду|
DEB|Дебрецен|Дебрецен|
DED|Дера Дун|Дера Дун|
DEL|Нью Дели|Нью Дели|
DEM|Дембидолло|Дембидолло|
DEN|Международный аэропорт Денвер|Денвер|
DEO|Диарборн|Диарборн|
DER|Дерим|Дерим|
DES|Десрочес|Десрочес|
DET|Детройт|Детройт|
DGA|Дангрига|Дангрига|
DGC|Дегабур|Дегабур|
DGE|Муджи|Муджи|
DGO|Дуранго|Дуранго|
DGP|Даугавпилс|Даугавпилс|
DGR|Даргавиль|Даргавиль|
DGT|Думагете|Думагете|
DGU|Дедугу|Дедугу|
DHA|Дахран|Дхахран|
DHF|Абу-Даби|Абу-Даби|
DHI|Дхангархи|Дхангархи|
DHL|Дала|Дала|
DHM|Дхарамсала|Дхарамсала|
DIB|Дибругарх|Дибругарх|
DIC|Дили|Дили|
DIJ|Дижон|Дижон|
DIL|Дили|Дили|
DIP|Диапага|Диапага|
DIW|Диквелла|Диквелла|
DIY|Диярбакыр|Диярбакыр|
DJA|Джугу|Джугу|
DJB|Джамби|Джамби|
DJE|Джерба|Джерба|
DJM|Джамбала|Джамбала|
DJU|Джупивогур|Джупивогур|
DKI|Данк Айленд|Данк Айленд|
DKR|Дакар|Дакар|
DKS|Диксон|Диксон|
DLA|Дуала|Дуала|
DLC|Далиан|Далиан|
DLD|Гейло|Гейло|
DLF|Дель Рио|Дель Рио|
DLI|Далат|Далат|
DLM|Даламан|Даламан|
DLU|Дали|Дали|
DLY|Диллонс-Бей|Диллонс-Бей|
DMA|Туксон|Туксон|
DMB|Жамбыл|Жамбыл|
DME|Домодедово|Москва|
DMR|Дамар|Дамар|
DMU|Димапур|Димапур|
DNA|Окинава|Окинава|
DND|Данди|Данди|
DNE|Даллас|Даллас|
DNF|Дерна|Дерна|
DNH|Дунхуань|Дунхуань|
DNI|Вад-Медани|Вад-Медани|
DNK|Днепропетровск|Днепропетровск|
DNP|Данг|Данг|
DNR|Динард|Динард|
DNT|Санта-Ана|Санта-Ана|
DNU|Динангат|Динангат|
DNX|Диндер|Диндер|
DNZ|Денизли|Денизли|
DOA|Доани|Доани|
DOC|Дорноч|Дорноч|
DOD|Додома|Додома|
DOE|Дьомье|Дьомье|
DOG|Донгола|Донгола|
DOH|Доха|Доха|
DOI|Дойни|Дойни|
DOK|Донецк|Донецк|
DOL|Дювиль|Дювиль|
DOM|Доминика|Доминика|
DON|Дос-Лагунас|Дос-Лагунас|
DOO|Доробисоро|Доробисоро|
DOP|Дольпа|Дольпа|
DOR|Дори|Дори|
DOS|Диос|Диос|
DPA|Чикаго|Чикаго|
DPE|Диеппе|Дьеп|
DPL|Диполог|Диполог|
DPO|Девонпорт|Девонпорт|
DPU|Думпу|Думпу|
DRJ|Дриетаббетье|Дриетаббетье|
DRM|Драма|Драма|
DRO|Дуранго|Дуранго|
DRS|Дрезден|Дрезден|
DRT|Дель Рио|Дель Рио|
DRW|Дарвин|Дарвин|
DSC|Дшанг|Дшанг|
DSD|Ла-Дезираде|Ла-Дезираде|
DSE|Десси|Десси|
DSI|Дестин|Дестин|
DSK|Дера-Исмаил-Хан|Дера-Исмаил-Хан|
DSL|Дару|Дару|
DTD|Датадавай|Датадавай|
DTE|Дает|Дает|
DTH|Долина Смерти|Долина Смерти|
DTM|Дортмунд|Дортмунд|
DUB|Дублин|Дублин|
DUD|Дунедин|Дунедин|
DUE|Дундо|Дундо|
DUM|Думаи|Думаи|
DUN|Дундас|Дундас|
DUR|Дурбан|Дурбан|
DUS|Дюссельдорф|Дюссельдорф|
DVA|Дева|Дева|
DVT|Феникс|Феникс|
DWB|Соалала|Соалала|
DWH|Хьюстон|Хьюстон|
DWN|Оклахома Сити|Оклахома Сити|
DWS|Орландо|Орландо|
DXA|До-Альпес|До-Альпес|
DXB|Дубай|Дубай|
DYG|Дэань|Дэань|
DYR|Угольный|Анадырь|
DYU|Душанбе|Душанбе|
DZI|Кодаси|Кодаси|
DZN|Жезказган|Жезказган|
DZU|Дазу|Дазу|
EAB|Аббсе|Аббсе|
EAE|Эмей|Эмей|
EAM|Неджран|Неджран|
EAS|Сан-Себастьян|Сан-Себастьян|
EBA|Марина Ди Кампо|Остров Эльба|
EBD|Эль-Обейд|Эль-Обейд|
EBJ|Эсбьерг|Эсбьерг|
EBM|Эль-Борма|Эль-Борма|
EBN|Эбадон|Эбадон|
EBR|Батон Руж|Батон Руж|
EBU|Сент Етьенн|Сент Етьенн|
EBW|Эболова|Эболова|
ECH|Эчука|Эчука|
ECN|Эркан|Эркан|
ECO|Эль-Энканто|Эль-Энканто|
ECR|Эль-Чарко|Эль-Чарко|
ECS|Ньюкасл|Ньюкасл|
EDF|Анкораж|Анкораж|
EDI|Эдинбург|Эдинбург|
EDK|Эль-Дорадо|Эль-Дорадо|
EDL|Элдорет|Элдорет|
EDM|Ла-Рош|Ла-Рош|
EDQ|Эрандике|Эрандике|
EFD|Хьюстон|Хьюстон|
EFG|Эфоги|Эфоги|
EFL|Кефалония|Кефалония|
EGA|Энгати|Энгати|
EGC|Бержерак|Бержерак|
EGI|Вальпараисо|Вальпараисо|
EGL|Негелли|Негелли|
EGM|Сиж|Сиж|
EGO|Белгород|Белгород|
EGS|Эгилсстадир|Эгилсстадир|
EHL|Эль-Больсон|Эль-Больсон|
EIA|Попондетта|Эйя|
EIB|Айзенах|Айзенах|
EIE|Енисейск|Енисейск|
EIN|Эйндховен|Эйндховен|
EIY|Эйн-Яхав|Эйн-Яхав|
EJA|Барранкабермежа|Барранкабермежа|
EJH|Ведих|Ведих|
EKB|Экибастуз|Экибастуз|
EKE|Экереку|Экереку|
EKT|Эскилстуна|Эскилстуна|
ELB|Эль-Банко|Эль-Банко|
ELD|Эль-Дорадо|Эль-Дорадо|
ELE|Эль-Реал|Эль-Реал|
ELF|Эль-Фашер|Эль-Фашер|
ELG|Эль-Голеа|Эль-Голеа|
ELJ|Эль-Рекрео|Эль-Рекрео|
ELL|Эллисрас|Эллисрас|
ELO|Эльдорадо|Эльдорадо|
ELP|Эль Пасо|Эль Пасо|
ELS|Ист Лондон|Ист-Лондон|
ELT|Тур-Синай-Сити|Тур-Синай-Сити|
EMB|Сан-Кристобаль|Сан-Кристобаль|
EME|Эмден|Эмден|
EMG|Эмпангени|Эмпангени|
EMI|Эмирау|Эмирау|
EML|Вейкфилд-Вестгейт|Люцерн|
EMN|Нема|Нема|
EMO|Эмо|Эмо|
EMS|Эмбесса|Эмбесса|
EMX|Эль-Майтен|Эль-Майтен|
EMY|Эль-Минья|Эль-Минья|
ENC|Ненси|Ненси|
ENE|Энде|Энде|
ENF|Енонтекио|Енонтекио|
ENH|Энши|Энши|
ENJ|Эль-Нараньо|Эль-Нараньо|
ENO|Инкарнасьон|Инкарнасьон|
ENS|Энсхеде|Энсхеде|
ENU|Энугу|Энугу|
EOI|Эдей|Эдей|
EOR|Эль-Дорадо|Эль-Дорадо|
EOZ|Элорса|Элорса|
EPI|Эпи|Эпи|
EPK|Эпископи|Эпископи|
EPL|Эпиналь|Эпиналь|
EPN|Эпена|Эпена|
EPS|Самана|Самана|
EPT|Элиптамин|Элиптамин|
EPU|Парну|Парну|
EQS|Эскель|Эскель|
ERA|Эригаво|Эригаво|
ERC|Эрзинкан|Эрзинкан|
ERD|Бердянск|Бердянск|
ERE|Эрейв|Эрейв|
ERF|Эрфурт|Эрфурт|
ERI|Эри|Эри|
ERS|Виндхек|Виндхек|
ERU|Эруме|Эруме|
ERZ|Эрзурум|Эрзурум|
ESB|Анкара|Анкара|
ESF|Александрия|Александрия|
ESG|Марискал-Эстигар|Марискал-Эстигар|
ESH|Шохем-Бай-Си|Шохем-Бай-Си|
ESK|Эскишехир|Эскишехир|
ESL|Элиста|Элиста|
ESR|Сальвадор|Сальвадор|
ESS|Эссен|Эссен|
ESU|Эссаурия|Эссаурия|
ETE|Генда-Вуха|Генда-Вуха|
ETH|Эйлат|Эйлат|
EUA|Эуа|Эуа|
EUG|Юджин|Юджин|
EUM|Ноймюнстер|Ноймюнстер|
EUN|Лаайюн|Лаайюн|
EUO|Паратебуэно|Паратебуэно|
EVE|Харстад-Нарвик|Харстад-Нарвик|
EVG|Свег|Свег|
EVN|Ереван|Ереван|
EVX|Эвро|Эвро|
EWE|Эвер|Эвер|
EWI|Энаротали|Энаротали|
EWK|Ньютон|Ньютон|
EWN|Нью Берн|Нью Берн|
EWO|Эво|Эво|
EXT|Эксетер|Эксетер|
EYL|Йелиман|Йелиман|
EYP|Эль-Йопал|Эль-Йопал|
EYS|Элийе-Спрингс|Элийе-Спрингс|
EYW|Ки Уэст|Ки Уэст|
EZE|Буэнос-Айрес|Буэнос-Айрес|
EZS|Елазиг|Элязыг|
FAA|Фаранах|Фаранах|
FAE|Вагар|Вагар|
FAG|Фагурхолсмыри|Фагурхолсмыри|
FAH|Фарах|Фарах|
FAN|Листа|Фарсунд|
FAO|Фаро|Фаро|
FAR|Фарго|Фарго|
FAS|Фаскрудсфьордур|Фаскрудсфьордур|
FAT|Фресно|Фресно|
FAV|Факарава|Факарава|
FAY|Файетвилл|Файетвилл|
FBD|Файзабад|Файзабад|
FCB|Фиксбург|Фиксбург|
FCH|Фресно-Чандлер|Фресно|
FCM|Миннеаполис|Миннеаполис|
FCO|Рим|Рим|
FCS|Колорадо Спрингз|Колорадо Спрингз|
FCT|Якима|Якима|
FDE|Форде|Форде|
FDH|Фридрихсхафен|Фридрихшафен|
FDU|Бандунду|Бандунду|
FEB|Санфебагар|Санфебагар|
FEG|Фергана|Фергана|
FER|Фергусонс-Галф|Фергусонс-Галф|
FES|Сан Фернандо|Сан Фернандо|
FEW|Чейнни|Чейнни|
FEZ|Фес|Фес|
FFU|Футалеуфу|Футалеуфу|
FGL|Фокс Гласиер|Фокс Гласиер|
FGR|Фенгерола|Фенгерола|
FGU|Фангатау|Фангатау|
FHZ|Факахина|Факахина|
FIE|Фейр-Айсл|Фейр-Айсл|
FIG|Фриа|Фриа|
FIN|Финшхафен|Финшхафен|
FKB|Карлсруэ|Карлсруэ|
FKJ|Фукуи|Фукуи|
FKS|Фукушима|Фукушима|
FLA|Капитолио|Флоренсиа|
FLB|Кангапара|Кангапара|
FLC|Фоллз-Крик|Фоллз-Крик|
FLE|Петерсбург|Петерсбург|
FLF|Фленсбург|Фленсбург|
FLL|Форт Лодердейл|Форт Лодердейл|
FLM|Филадельфия|Филадельфия|
FLN|Флорианополис|Флорианополис|
FLO|Флоренция|Флоренция|
FLR|Перетола|Флоренция|
FLU|Нью-Йорк|Нью-Йорк|
FLW|Санта-Круз|Санта-Круз|
FMA|Формоса|Формоса|
FMH|Фолмаут|Фолмаут|
FMI|Калемие|Калемие|
FMY|Форт Майерс|Форт Майерс|
FNE|Фейн|Фейн|
FNG|Фада-Нгурма|Фада-Нгурма|
FNH|Финча|Финча|
FNI|Ним|Ним|
FNJ|Пхеньян|Пхеньян|
FNT|Флинт|Флинт|
FOC|Фучжоу|Фучжоу|
FOG|Фоджия|Фоджия|
FOM|Фумбан|Фумбан|
FOO|Нумфоор|Нумфоор|
FOP|Форест Парк|Форест Парк|
FOR|Форталеса|Форталеса|
FOU|Фугаму|Фугаму|
FOY|Фойя|Фойя|
FRA|Франкфурт-на-Майне|Франкфурт-на-Майне|
FRC|Франка|Франка|
FRE|Фера-Айленд|Фера-Айленд|
FRF|Франкфурт-на-Майне|Франкфурт-на-Майне|
FRJ|Фреюс|Фрехус|
FRL|Форли|Форли|
FRO|Флора|Флоро|
FRQ|Ферамин|Ферамин|
FRS|Санта-Элена|Флорес|
FRT|Фрутильяр|Фрутильяр|
FRU|Манас|Бишкек|
FRW|Франсистаун|Франсистаун|
FSS|Форрес|Форрес|
FTA|Футуна-Айленд|Футуна-Айленд|
FTI|Фитута|Фитута|
FTU|Форт-Дофин|Форт-Дофин|
FTW|Форт Уорт|Форт Уорт|
FTY|Атланта|Атланта|
FUB|Фуллборн|Фуллборн|
FUE|Фуэртевентура|Фуэртевентура|
FUG|Фуан|Фуан|
FUJ|Фуку|Фуку|
FUK|Фукуока|Фукуока|
FUM|Фума|Фума|
FUO|Фушань|Фушань|
FUT|Футуна-Айленд|Футуна-Айленд|
FWA|Форт Уэйн|Форт Уэйн|
FWM|Форт-Вильям|Форт-Вильям|
FXE|Форт Лодердейл|Форт Лодердейл|
FYM|Файетвилл|Файетвилл|
FYN|Фуюнь|Фуюнь|
FYT|Файя|Файя|
FYV|Файетвилл|Файетвилл|
FZO|Филтон|Бристоль|
GAA|Гуамал|Гуамал|
GAC|Грация|Грация|
GAE|Габес|Габес|
GAF|Гафса|Гафса|
GAJ|Ямагата|Ямагата|
GAN|Ген-Айленд|Ген-Айленд|
GAO|Гуантанамо|Гуантанамо|
GAP|Гусап|Гусап|
GAQ|Гао|Гао|
GAR|Гарайна|Гарайна|
GAS|Гарисса|Гарисса|
GAT|Гап|Гап|
GAV|Гаг-Айленд|Гаг-Айленд|
GAW|Ганго|Ганго|
GAX|Гамба|Гамба|
GAY|Гайя|Гайя|
GBA|Биг-Бей|Биг-Бей|
GBB|Гара-Джебилет|Гара-Джебилет|
GBC|Гасуке|Гасуке|
GBE|Габороне|Габороне|
GBF|Негарбо|Негарбо|
GBJ|Мари-Галанте|Мари-Галанте|
GBK|Гбангбаток|Гбангбаток|
GBM|Гарбахари|Гарбахари|
GBN|Сан Джованни Ротондо|Сан Джованни Ротондо|
GBO|Балтимор|Балтимор|
GBS|Порт-Фицрой|Порт-Фицрой|
GBZ|Грейт-Барьер-Айленд|Грейт-Барьер-Айленд|
GCC|Жилетте|Жилетте|
GCI|Гернси|Гернси|
GCJ|Йоханнесбург|Йоханнесбург|
GDA|Гунда|Гунда|
GDG|Магдагачи|Магдагачи|
GDI|Гордил|Гордил|
GDJ|Гандаджика|Гандаджика|
GDL|Гуадалахара|Гуадалахара|
GDN|Гданьск|Гданьск|
GDP|Гуадалупе|Гуадалупе|
GDQ|Гондэр|Гондэр|
GDX|Сокол|Магадан|
GDZ|Геленджик|Геленджик|
GEB|Гебе|Гебе|
GEC|Геситкале|Геситкале|
GEF|Жева-Эйрстрип|Жева-Эйрстрип|
GEG|Спокане|Спокане|
GEN|Осло|Осло|
GER|Нуэва-Герона|Нуэва-Герона|
GES|Женерал-Сантос|Женерал-Сантос|
GEV|Галливаре|Галливаре|
GEX|Гелонг|Гелонг|
GFO|Бартика|Бартика|
GFR|Гранвиль|Гранвиль|
GFY|Грутфонтейн|Грутфонтейн|
GGC|Лумбала|Лумбала|
GGL|Жилгал|Жилгал|
GHD|Гимби|Гимби|
GHE|Гарахин|Гарахин|
GHK|Гуш-Катиф|Гуш-Катиф|
GHN|Гуанчжань|Гуанчжань|
GHT|Гат|Гат|
GHU|Гуалегуайчу|Гуалегуайчу|
GIB|Гибралтар|Гибралтар|
GII|Сигуири|Сигуири|
GIL|Гилгит|Гилгит|
GIM|Миеле-Мимбале|Миеле-Мимбале|
GIS|Гисборн|Гизборн|
GIT|Гейта|Гейта|
GIU|Сигирия|Сигирия|
GJT|Гранд Джанкшн|Гранд Джанкшн|
GKA|Горока|Горока|
GKE|Гайленкирхен|Гайленкирхен|
GKH|Горкха|Горкха|
GKO|Конгобумба|Конгобумба|
GKT|Гатлинбург|Гатлинбург|
GLC|Гелади|Гелади|
GLF|Голфито|Голфито|
GLK|Галкайо|Галкайо|
GLL|Гол|Гол|
GLM|Гленормистон|Гленормистон|
GLN|Гулимим|Гулимим|
GLO|Глучестер|Глучестер|
GLP|Гулгубип|Гулгубип|
GLS|Гелвстон|Гелвстон|
GLT|Гледстоун|Гледстоун|
GLX|Галела|Галела|
GLZ|Бреда|Бреда|
GMB|Гамбела|Гамбела|
GMC|Герима|Герима|
GME|Гомель|Гомель|
GMI|Гасмата-Айленд|Гасмата-Айленд|
GMM|Гамбома|Гамбома|
GMN|Греймауз|Греймауз|
GMS|Гимараес|Гимараес|
GMV|Моньюмент Вэлли|Моньюмент Вэлли|
GMY|Райндален|Райндален|
GNA|Гродно|Гродно|
GNB|Гренобль|Гренобль|
GNE|Гент|Гент|
GNI|Грин-Айленд|Грин Айленд|
GNN|Гиннир|Гиннир|
GNR|Хенераль-Рока|Хенераль-Рока|
GNS|Гунунгситоли|Гунунгситоли|
GNT|Милан|Милан|
GNZ|Ганзи|Ганзи|
GOB|Гоба|Гоба|
GOC|Гора|Гора|
GOI|Гоа|Гоа|
GOJ|Стригино|Нижний Новгород|
GOM|Гома|Гома|
GOP|Горахпур|Горахпур|
GOQ|Голмуд|Голмуд|
GOR|Гор|Гор|
GOT|Готенбург|Готенбург|
GOU|Гаруа|Гаруа|
GOY|Гал-Ойя|Гал-Ойя|
GPA|Патрас|Патрас|
GPI|Гуапи|Гуапи|
GPL|Гуапайлз|Гуапайлз|
GPO|Хенераль-Пико|Хенераль-Пико|
GRA|Гамарра|Гамарра|
GRB|Грин Бэй|Грин Бэй|
GRC|Гранд-Цесс|Гранд-Цесс|
GRF|Такома|Такома|
GRG|Гардез|Гардез|
GRH|Гаруахи|Гаруахи|
GRJ|Джордж|Джордж|
GRL|Гараса|Гараса|
GRO|Герона|Герона|
GRQ|Гронинген|Гронинген|
GRS|Гроссето|Гроссето|
GRT|Гуджрат|Гуджрат|
GRU|Сао Паоло|Сао Паоло|
GRV|Грозный|Грозный|
GRX|Гранада|Гранада|
GRY|Гримси|Гримси|
GRZ|Грац|Грац|
GSE|Готенбург|Готенбург|
GSI|Гуадалканал|Гуадалканал|
GSR|Гардо|Гардо|
GSU|Гедарев|Гедарев|
GSY|Гримсби|Гримсби|
GTB|Гентинг|Гентинг|
GTI|Гюттин|Гюттин|
GTN|Маунт Кук|Маунт Кук|
GTO|Горонтало|Горонтало|
GTW|Злин|Злин|
GTY|Геттисберг|Геттисберг|
GUA|Гватемала Сити|Гватемала Сити|
GUB|Гверреро-Негро|Гверреро-Негро|
GUD|Гундам|Гундам|
GUG|Гуари|Гуари|
GUI|Гуйриа|Гуйриа|
GUL|Гоулбурн|Гоулбурн|
GUO|Гуалако|Гуалако|
GUP|Галлап|Галлап|
GUQ|Гуанаре|Гуанаре|
GUV|Мугулу|Мугулу|
GUW|Атырау|Атырау|
GUX|Гуна|Гуна|
GVA|Женева|Женева|
GVI|Грин-Ривер|Грин-Ривер|
GVX|Гавле|Гавле|
GWD|Гвадар|Гвадар|
GWE|Гверу|Гверу|
GWL|Гуалиор|Гвалиор|
GWW|Берлин|Берлин|
GWY|Голуэй|Голуэй|
GXF|Сейюн|Сейюн|
GXG|Негаге|Негаге|
GXH|Милденхолл|Милденхолл|
GXQ|Койайке|Койайке|
GXX|Ягуа|Ягуа|
GYA|Гуаярамерин|Гуаярамерин|
GYD|Гейдар Алиев|Баку|
GYE|Гуайяквил|Гуайяквил|
GYI|Гисеный|Гисеный|
GZI|Газни|Газни|
GZM|Гозо|Гозо|
GZO|Гизо|Гизо|
GZT|Газиантеп|Газиантеп|
HAA|Хасвик|Хасвик|
HAB|Гамильтон|Гамильтон|
HAD|Халмстад|Халмстад|
HAJ|Ганновер|Ганновер|
HAK|Хайкоу|Хайкоу|
HAL|Халали|Халали|
HAM|Аэропорт Гамбурга|Гамбург|
HAN|Ханой|Ханой|
HAO|Гамильтон|Гамильтон|
HAP|Лонг Айленд|Лонг Айленд|
HAS|Хаиль|Хаиль|
HAU|Хаугезунд|Хаугезунд|
HAV|Гавана|Гавана|
HAZ|Хетцфельдтавен|Хетцфельдтавен|
HBA|Хобарт|Хобарт|
HBE|Борк Эль Араб|Александрия|
HBG|Хаттисберг|Хаттисберг|
HBI|Харбор-Айленд|Харбор-Айленд|
HBL|Бабелеги|Бабелеги|
HBR|Хобарт|Хобарт|
HBT|Хафр-Альбатин|Хафр-Альбатин|
HBX|Хубли|Хубли|
HCQ|Холлз Крик|Холлз Крик|
HCS|Йоханнесбург|Йоханнесбург|
HDB|Хайдельберг|Хайдельберг|
HDD|Хайдерабад|Хидерабад|
HDF|Херингсдорф|Херингсдорф|
HDM|Хамадан|Хамадан|
HDY|Хат Яй|Хат Яй|
HEA|Герат|Герат|
HEB|Хензада|Хензада|
HEE|Хелена|Хелена|
HEH|Хехо|Хехо|
HEK|Хейхе|Хейхе|
HEL|Хельсинки-Вантаа|Хельсинки-Вантаа|
HEM|Хельсинки-Мальми|Хельсинки|
HET|Хоххот|Хоххот|
HEV|Гуелва|Гуелва|
HEW|Афины|Афины|
HEX|Санто-Доминго|Санто-Доминго|
HEZ|Натчез|Натчез|
HFA|Хайфа|Хайфа|
HFD|Хартфорд|Хартфорд|
HFE|Шанхай|Хефей|
HFS|Хагфорс|Хагфорс|
HFT|Хаммерфест|Хаммерфест|
HGA|Харгейса|Харгейса|
HGH|Ханчжоу|Ханчжоу|
HGL|Хелголанд|Хелголанд|
HGN|Мей-Хонг-Сон|Мей-Хонг-Сон|
HHA|Чанша|Чанша|
HHE|Хачинохе|Хачинохе|
HHP|Гонконг|Гонконг|
HHQ|Хуа-Хин|Хуа-Хин|
HHZ|Хикуэру|Хикуэру|
HIC|Претория|Претория|
HID|Хорн-Айленд|Хорн-Айленд|
HIF|Огден|Огден|
HIG|Хайбери|Хайбери|
HIH|Хук-Айленд|Хук-Айленд|
HIJ|Хиросима|Хиросима|
HIK|Гонолулу|Гонолулу|
HIL|Шилаво|Шилаво|
HIO|Портланд|Портланд|
HIS|Хейман Айленд|Хейман Айленд|
HIT|Хиваро|Хиваро|
HIW|Хиросима|Хиросима|
HJR|Кхаджурахо|Кхаджурахо|
HKD|Хакодате|Хакодате|
HKG|Гонконг|Гонконг|
HKK|Хокитика|Хокитика|
HKS|Джексон|Джексон|
HKT|Пхукет|Пхукет|
HKV|Хасково|Хасково|
HLA|Лансерия|Лансерия|
HLD|Хайлар|Хайлар|
HLF|Хултсфред|Хултсфред|
HLH|Уланьхот|Уланьхот|
HLN|Хелена|Хелена|
HLP|Джакарта|Джакарта|
HLS|Сент Хеленс|Сент Хеленс|
HLT|Гамильтон|Гамильтон|
HLV|Хеленвейл|Хеленвейл|
HLW|Хлухлуве|Хлухлуве|
HLZ|Гамильтон|Гамильтон|
HMA|Ханты-Мансийск|Ханты-Мансийск|
HMI|Хами|Хами|
HMJ|Хмельницкий|Хмельницкий|
HMN|Аламогордо|Аламогордо|
HMO|Хермосилльо|Хермосилльо|
HMR|Хамар|Хамар|
HND|Токио|Токио|
HNG|Хьенгене|Хьенгене|
HNI|Хейвени|Хейвени|
HNL|Гонолулу|Гонолулу|
HNN|Хонинаби|Хонинаби|
HNY|Хеньян|Хеньян|
HOA|Хола|Хола|
HOE|Хоуисей|Хоуисей|
HOG|Голгуин|Голгуин|
HOH|Хохенемс|Хохенемс|
HOI|Хао-Айленд|Хао-Айленд|
HOO|Кваньдук|Кваньдук|
HOQ|Хоф|Хоф|
HOV|Ховден|Ховден|
HOX|Хомалин|Хомалин|
HOY|Хой-Айленд|Хой-Айленд|
HPH|Хейфонг|Хейфонг|
HPR|Претория|Претория|
HRA|Мансехра|Мансехра|
HRB|Харбин|Харбин|
HRC|Жарейм|Жайрем|
HRE|Хараре|Хараре|
HRG|Хургада|Хургада|
HRJ|Чаурджхари|Чаурджхари|
HRK|Харьков|Харьков|
HRL|Харлинген|Харлинген|
HRN|Герон Айленд|Герон Айленд|
HRR|Херрера|Херрера|
HRS|Харрисмит|Харрисмит|
HRT|Херрогейт|Херрогейт|
HSB|Ралей|Ралей|
HSC|Шаньгван|Шаогуань|
HSH|Лас Вегас|Лас Вегас|
HSK|Хуэска|Хуэска|
HSN|Чжушань|Чжушань|
HSS|Хиссар|Хиссар|
HTA|Чита|Чита|
HTG|Хатанга|Хатанга|
HTI|Хамилтон Айленд|Хамилтон Айленд|
HTN|Хотань|Хотан|
HTR|Хатерума|Хатерума|
HTZ|Хато-Коросал|Хато-Коросал|
HUB|Хамберт-Ривер|Хамберт-Ривер|
HUE|Хумера|Хумера|
HUG|Хухутенанго|Хухутенанго|
HUI|Гуе|Гуе|
HUN|Хуалянь|Хуалянь|
HUQ|Хоун|Хоун|
HUU|Уануко|Уануко|
HUV|Худиксвалл|Худиксвалл|
HUX|Хуатулко|Хуатулко|
HUY|Хамберсайд|Хамберсайд|
HUZ|Хуэйчжоу|Хуэйчжоу|
HVA|Аналалава|Аналалава|
HVB|Херви Бей|Херви Бей|
HVG|Хоннигсвог|Хоннигсвог|
HVK|Холмавик|Холмавик|
HVM|Хваммстанги|Хваммстанги|
HWA|Хавабанго|Хавабанго|
HWO|Холливуд|Холливуд|
HYA|Хианнис|Хианнис|
HYC|Хай-Вайкомб|Хай-Вайкомб|
HYD|Хидерабад|Хидерабад|
HYF|Хейфильдз|Хейфильдз|
HYN|Хуанань|Хуанань|
HYV|Хивинкаа|Хивинкаа|
HZB|Хазебрук|Хазебрук|
HZG|Ханьчжун|Ханьчжун|
HZK|Хусавик|Хусавик|
HZV|Хезивью|Хезивью|
IAA|Игарка|Игарка|
IAB|Вичита|Вичита|
IAG|Ниагара Фоллз|Ниагара Фоллз|
IAH|Хьюстон|Хьюстон|
IAQ|Бахреган|Бахреган|
IAR|Туношна|Ярославль|
IAS|Иаси|Иаси|
IBA|Ибадан|Ибадан|
IBE|Ибаги|Ибаги|
IBI|Ибоки|Ибоки|
IBO|Ибо|Ибо|
IBP|Иберия|Иберия|
IBZ|Ибица|Ибица|
ICA|Икабару|Икабару|
ICI|Кикия|Кикия|
ICN|Сеул|Сеул|
ICR|Никаро|Никаро|
ICT|Вичита|Вичита|
IDA|Айдахо Фоллз|Айдахо Фоллз|
IDB|Идре|Идре|
IDF|Идиофа|Идиофа|
IDN|Индаген|Индаген|
IDP|Индепенденс|Индепенденс|
IDR|Индор|Индор|
IEG|Зелена-Гора|Зелена-Гора|
IEJ|Иежима|Иежима|
IEV|Жуляны|Киев|
IFJ|Исафьордур|Исафьордур|
IFN|Исфахан|Исфахан|
IFO|Иваново-Франковск|Ивано-Франковск|
IGB|Инженеро-Джако|Инженеро-Джако|
IGE|Игуэла|Игуэла|
IGL|Измир|Измир|
IGN|Илиган|Илиган|
IGO|Чигородо|Чигородо|
IHN|Кишн|Кишн|
IHO|Ихоси|Ихоси|
IHU|Иху|Иху|
IIA|Инишмаан|Инишмаан|
IIN|Нисиноомоте|Нисиноомоте|
IIS|Ниссан-Айленд|Ниссан-Айленд|
IJK|Ижевск|Ижевск|
IKI|Ики|Ики|
IKL|Икела|Икела|
IKS|Тикси|Тикси|
IKT|Иркутск|Иркутск|
ILA|Иллага|Иллага|
ILK|Илака|Илака|
ILO|Йоило|Йоило|
ILR|Илорин|Илорин|
ILU|Килагуни|Килагуни|
ILZ|Жилина|Жилина|
IMA|Иамалеле|Иамалеле|
IMB|Имбаимадай|Имбаимадай|
IMD|Имонда|Имонда|
IMF|Имфал|Имфал|
IMG|Иньяминга|Иньяминга|
IMK|Симикот|Симикот|
IMZ|Нимроз|Нимроз|
INA|Инта|Инта|
INB|Индепенденс|Индепенденс|
INC|Фучуан|Фучуан|
INE|Шинде|Шинде|
INF|Ин-Геззам|Ин-Геззам|
INH|Иньямбане|Иньямбане|
INI|Ниш|Ниш|
INN|Инсбрук|Инсбрук|
INO|Инонго|Инонго|
INQ|Инишир|Инишир|
INR|Со Сен Мари|Со Сен Мари|
INX|Инанватан|Инанватан|
INZ|Ин-Салах|Ин-Салах|
IOA|Ионина|Иоаннина|
IOK|Иокеа|Иокеа|
ION|Импфондо|Импфондо|
IOP|Иома|Иома|
IOR|Инишмор|Инишмор|
IOS|Илеус|Илеус|
IOW|Айова Сити|Айова Сити|
IPA|Ипота|Ипота|
IPE|Ипил|Ипил|
IPG|Ипиранга|Ипиранга|
IPH|Ипох|Ипох|
IPI|Сан-Луис|Ипиалес|
IPN|Ипатинга|Ипатинга|
IPW|Ипсвич|Ипсвич|
IQM|Куэмо|Куэмо|
IQN|Куаньян|Куаньян|
IQQ|Икуике|Икуике|
IQT|Икуитос|Икуитос|
IRA|Киракира|Киракира|
IRI|Иринга|Иринга|
IRJ|Ла-Риоха|Ла-Риоха|
IRN|Ириона|Ириона|
ISD|Искуанде|Искуанде|
ISE|Испарта|Испарта|
ISG|Исигаки|Исигаки|
ISH|о.Искья|о.Искья|
ISJ|Айла Мухерес|Айла Мухерес|
ISK|Насик|Насик|
ISM|Киссимми|Киссимми|
IST|Стамбул|Стамбул|
ITK|Итокама|Итокама|
ITM|Осака|Осака|
IUE|Ниуе-Айленд|Ниуе-Айленд|
IUS|Инус|Инус|
IVA|Амбандза|Амбандза|
IVC|Инверкаргилл|Инверкаргилл|
IVG|Иванград|Иванград|
IVL|Ивало|Ивало|
IVO|Чиволо|Чиволо|
IWA|Иваново|Иваново|
IWJ|Ивами|Ивами|
IWS|Хьюстон|Хьюстон|
IXA|Агартала|Агартала|
IXB|Багдогра|Багдогра|
IXC|Чандигарх|Чандигарх|
IXD|Аллахабад|Аллахабад|
IXE|Мангалор|Мангалор|
IXG|Белгаум|Белгаум|
IXH|Кайлашахар|Кайлашахар|
IXI|Лилабари|Лилабари|
IXJ|Джамму|Джамму|
IXK|Кешод|Кешод|
IXL|Лех|Лех|
IXM|Мадурай|Мадурай|
IXN|Ховаи|Ховаи|
IXP|Патханкот|Патханкот|
IXQ|Камалпур|Камалпур|
IXR|Ранчи|Ранчи|
IXS|Силчар|Силчар|
IXT|Пасигхат|Пасигхат|
IXU|Аурангабад|Аурангабад|
IXV|Алонг|Алонг|
IXW|Джамшедпур|Джамшедпур|
IXY|Кандия|Кандия|
IXZ|Порт-Блер|Порт-Блер|
IZO|Идзумо|Идзумо|
IZT|Ихтепек|Ихтепек|
JAA|Джелалабад|Джелалабад|
JAB|Джабиру|Джабиру|
JAC|Джексон|Джексон|
JAD|Перт|Перт|
JAE|Атланта|Атланта|
JAF|Джафна|Джафна|
JAG|Джакобабад|Джакобабад|
JAI|Джайпур|Джайпур|
JAJ|Атланта|Атланта|
JAL|Халапа|Халапа|
JAM|Джамбол|Джамбол|
JAN|Джексон|Джексон|
JAO|Атланта|Атланта|
JAP|Пунта Ренес|Пунта Ренес|
JAQ|Жакино-Бей|Жакино-Бей|
JAS|Джаспер|Джаспер|
JAU|Хауха|Хауха|
JBC|Бостон|Бостон|
JBP|Лос Анджелес|Лос Анджелес|
JCA|Канны|Канны|
JCC|Сан-Кристобаль|Сан-Кристобаль|
JCN|Инчеон|Инчеон|
JCU|Сеута|Сеута|
JCX|Лос Анджелес|Лос Анджелес|
JDB|Даллас|Даллас|
JDH|Джодхпур|Джодхпур|
JDM|Майами|Майами|
JDN|Иордания|Иордания|
JDP|Париж|Париж|
JDT|Миннеаполис|Миннеаполис|
JDX|Хьюстон|Хьюстон|
JDZ|Цзиньдэчжэнь|Цзиньдэчжэнь|
JED|Джедда|Джедда|
JEE|Жереми|Жереми|
JEJ|Джех|Джех|
JER|Джерси|Джерси|
JFK|Нью-Йорк|Нью-Йорк|
JFM|Фримантл|Фримантл|
JFR|Паармют|Паармют|
JGA|Джамнагар|Джамнагар|
JGB|Джагдалпур|Джагдалпур|
JGL|Атланта|Атланта|
JGN|Цзяюйгуань|Цзяюйгуань|
JGP|Хьюстон|Хьюстон|
JGQ|Хьюстон|Хьюстон|
JHB|Джохор-Бару|Джохор-Бару|
JHG|Цзиньхонг|Цзиньхонг|
JHW|Джеймстаун|Джеймстаун|
JHY|Кембрдидж|Кембрдидж|
JIB|Джибути|Джибути|
JID|Лос Анджелес|Лос Анджелес|
JIJ|Джиджига|Джиджига|
JIL|Цзилинь|Цзилинь|
JIM|Джимма|Джимма|
JIN|Джинджа|Джинджа|
JIP|Хипихапа|Хипихапа|
JIR|Джири|Джири|
JIU|Цзюцзянь|Цзюцзянь|
JIW|Дживани|Дживани|
JJI|Хуанхуй|Хуанхуй|
JJN|Цзиньян|Цзиньян|
JKG|Йонкопинг|Йонкопинг|
JKH|Хиос|Хиос|
JKR|Джанакпур|Джанакпур|
JKT|Джакарта|Джакарта|
JLO|Езоло|Езоло|
JLR|Джабалпур|Джабалпур|
JLX|Лос Анджелес|Лос Анджелес|
JMA|Хьюстон|Хьюстон|
JMB|Джамба|Джамба|
JMD|Даллас|Даллас|
JMK|Миконос|Миконос|
JMM|Малмо|Малмо|
JMO|Джомсом|Джомсом|
JMS|Джеймстаун|Джеймстаун|
JMU|Цзиамуси|Джаймуси (Китай)|
JNG|Цзинин|Цзинин|
JNH|Даллас|Даллас|
JNI|Хунин|Хунин|
JNN|Нанорталик|Нанорталик|
JNP|Ньюпорт Бич|Ньюпорт Бич|
JNX|Наксо|Наксо|
JNZ|Цзичжоу|Цзиньчжоу|
JOC|Санта-Ана|Санта-Ана|
JOE|Йоенсуу|Йонсуу|
JOG|Джогиякарта|Джогиякарта|
JOK|Йошкар-Ола|Йошкар-Ола|
JOL|Жоло|Жоло|
JOM|Ньомбе|Ньомбе|
JOP|Жозефсталль|Жозефсталль|
JOR|Орандж|Орандж|
JOS|Йос|Йос|
JPA|Жоао Пессоа|Жоао Пессоа|
JPT|Хьюстон|Хьюстон|
JPU|Париж|Париж|
JQE|Жак|Жак|
JRA|Нью-Йорк|Нью-Йорк|
JRC|Рочестер|Рочестер|
JRE|Нью-Йорк|Нью-Йорк|
JRH|Йорхат|Йорхат|
JRK|Арсук|Арсук|
JRO|Килиманджаро|Килиманджаро|
JRS|Иерусалим|Иерусалим|
JSA|Джайсалмер|Джайсалмер|
JSG|Сан-Рафаэль|Сан-Рафаэль|
JSI|Скиатлос|Скиатлос|
JSL|Атлантик Сити|Атлантик Сити|
JSN|Лос Анджелес|Лос Анджелес|
JSO|Содерталье|Содерталье|
JSR|Джессор|Джессор|
JSS|Спецаи-Айленд|Спецаи-Айленд|
JSY|Сирос-Айленд|Сирос-Айленд|
JTO|Таузэнд Оукс|Таузэнд Оукс|
JUA|Жуара|Жуара|
JUB|Джуба|Джуба|
JUC|Лос Анджелес|Лос Анджелес|
JUI|Юист|Юист|
JUJ|Хухуй|Хухуй|
JUL|Хулиака|Хулиака|
JUM|Джумла|Джумла|
JUO|Журадо|Журадо|
JUT|Хутикальпа|Хутикальпа|
JUV|Упернавик|Упернавик|
JVA|Анкавандра|Анкавандра|
JWA|Жваненг|Жваненг|
JWC|Лос Анджелес|Лос Анджелес|
JWH|Хьюстон|Хьюстон|
JWL|Хьюстон|Хьюстон|
JXN|Джексон|Джексон|
JYV|Ювяскюля|Ювяскюля|
KAA|Касама|Касама|
KAB|Кариба|Кариба|
KAC|Камешли|Камешли|
KAD|Кадуна|Кадуна|
KAF|Карато|Карато|
KAG|Гангнеунг|Гангнеунг|
KAH|Мельбурн|Мельбурн|
KAI|Каетер|Каетер|
KAJ|Каяне|Каяне|
KAN|Кано|Кано|
KAO|Кусамо|Кусамо|
KAP|Капанга|Капанга|
KAQ|Камулай|Камулай|
KAR|Камаранг|Камаранг|
KAS|Карасбург|Карасбург|
KAT|Кайтайа|Кайтайа|
KAU|Каухава|Каухава|
KAV|Каванаен|Каванаен|
KAW|Котонг|Котонг|
KAY|Вакая-Айленд|Вакая-Айленд|
KAZ|Кау|Кау|
KBA|Кабала|Кабала|
KBB|Киркимби|Киркимби|
KBF|Карубага|Карубага|
KBH|Калат|Калат|
KBI|Криби|Криби|
KBJ|Кингз Каньон|Кингз Каньон|
KBM|Кабвум|Кабвум|
KBN|Кабинда|Кабинда|
KBO|Кабало|Кабало|
KBP|Борисполь|Борисполь|
KBQ|Касунгу|Касунгу|
KBR|Кота-Бару|Кота-Бару|
KBU|Котабару|Котабару|
KBV|Краби|Краби|
KBX|Камбуая|Камбуая|
KBZ|Каикоура|Каикоура|
KCA|Куга|Куга|
KCB|Касикасима|Касикасима|
KCH|Кучинг|Кучинг|
KCK|Канзас Сити|Канзас Сити|
KCO|Косаели|Косаели|
KCP|Каменец-Подольский|Каменец-Подольский|
KCS|Кингз-Крик|Кингз Крик Стэйшн|
KCT|Коггала|Коггала|
KCU|Масинди|Масинди|
KCZ|Кочи|Кочи|
KDA|Колда|Колда|
KDC|Канди|Канди|
KDD|Хуздар|Хуздар|
KDE|Короба|Короба|
KDG|Карджали|Карджали|
KDH|Кандагар|Кандагар|
KDL|Кярдла|Кярдла|
KDP|Кандеп|Кандеп|
KDR|Кандриан|Кандриан|
KDU|Скарду|Скарду|
KDV|Кандаву|Кандаву|
KDW|Канди|Канди|
KEA|Кейса|Кейса|
KEC|Касенга|Касенга|
KED|Кеди|Кеди|
KEE|Келле|Келле|
KEF|Рейкьявик|Рейкьявик|
KEG|Кегльсугль|Кегльсугль|
KEI|Кепи|Кепи|
KEJ|Кемерово|Кемерово|
KEL|Киел|Киел|
KEN|Кенема|Кенема|
KEP|Непалгандж|Непалгандж|
KEQ|Кебар|Кебар|
KER|Керман|Керман|
KEX|Канабеа|Канабеа|
KEY|Керичо|Керичо|
KFA|Киффа|Киффа|
KFG|Калкурунг|Калкурунг|
KFS|Кастамону|Кастамону|
KGA|Кананга|Кананга|
KGB|Конге|Конге|
KGD|Калининград|Калининград|
KGF|Карагандинский международный аэропорт|Караганда|
KGG|Кедугу|Кедугу|
KGH|Йонгай|Йонгай|
KGI|Калгурли|Калгурли|
KGJ|Каронга|Каронга|
KGN|Казонго-Лунда|Казонго-Лунда|
KGO|Кировоград|Кировоград|
KGP|Когалым|Когалым|
KGS|Кос|Кос|
KGU|Кенингау|Кенингау|
KGW|Каги|Каги|
KGY|Кингарой|Кингарой|
KHA|Ханех|Ханех|
KHC|Керчь|Керчь|
KHE|Херсон|Херсон|
KHG|Каши|Каши|
KHJ|Каухайоки|Каухайоки|
KHL|Кхулна|Кхулна|
KHM|Хамти|Хамти|
KHN|Наньчан|Наньчан|
KHS|Хасаб|Хасаб|
KHT|Хост|Хост|
KHU|Кременчуг|Кременчуг|
KHV|Хабаровск (Новый)|Хабаровск|
KIA|Кайапит|Кайапит|
KID|Кристианстад|Кристианстад|
KIE|Киета|Киета|
KIH|Киш Айленд|Киш-Айленд|
KIJ|Ниигата|Ниигата|
KIK|Киркук|Киркук|
KIL|Килва|Килва|
KIM|Кимберли|Кимберли|
KIN|Кингстоун|Кингстоун|
KIQ|Кира|Кира|
KIS|Кисуму|Кисуму|
KIT|Китира|Китира|
KIU|Киунга|Киунга|
KIV|Кишинев|Кишинев|
KIW|Китве|Китве|
KIX|Осака|Осака|
KIY|Килва|Килва|
KIZ|Кикинонда|Кикинонда|
KJA|Емельяново|Красноярск|
KJP|Керама|Керама|
KJU|Камираба|Камираба|
KKC|Кхон Каен|Кхон Каен|
KKD|Кокода|Кокода|
KKG|Конаварук|Конаварук|
KKJ|Кита-Кюсю|Кита-Кюсю|
KKM|Лоп Бури|Лоп Бури|
KKN|Киркенес|Киркенес|
KKO|Кайкоэ|Кайкоэ|
KKW|Киквит|Киквит|
KKX|Кикаига-Сима|Кикаига-Сима|
KKY|Килкенни|Килкенни|
KLB|Калабо|Калабо|
KLC|Каолак|Каолак|
KLD|Мигалово|Тверь|
KLE|Келе|Келе|
KLF|Калуга|Калуга|
KLH|Колхапур|Колхапур|
KLK|Калокол|Калокол|
KLO|Калибо|Калибо|
KLQ|Келуанг|Келуанг|
KLR|Калмар|Калмар|
KLT|Кайзерслаутерн|Кайзерслаутен|
KLU|Клагенфурт|Клагенфурт|
KLV|Карловы Вары|Карловы-Вары|
KLX|Каламата|Каламата|
KLY|Калима|Калима|
KLZ|Кляйнзи|Кляйнзи|
KMA|Керема|Керема|
KMB|Койнамбе|Койнамбе|
KMD|Манджи|Манджи|
KME|Камембе|Камембе|
KMF|Камина|Камина|
KMG|Кунминг|Кунминг|
KMH|Куруман|Куруман|
KMI|Миядзаки|Миядзаки|
KMJ|Кумамото|Кумамото|
KMK|Макабана|Макабана|
KMM|Кимам|Кимам|
KMN|Камина|Камина|
KMP|Китмансхуп|Китмансхуп|
KMQ|Коматсу|Коматсу|
KMR|Каримуи|Каримуи|
KMS|Кумаси|Кумаси|
KMT|Кампот|Кампот|
KMU|Кисмайо|Кисмайо|
KMV|Калемьо|Калемьо|
KMW|Кострома|Кострома|
KNA|Вина дель Мар|Винья-дель-Мар|
KNB|Канаб|Канаб|
KND|Кинду|Кинду|
KNE|Канайндж|Канайндж|
KNG|Каймана|Каймана|
KNH|Кинмень|Кинмень|
KNJ|Киндамба|Киндамба|
KNM|Каниама|Каниама|
KNN|Канкан|Канкан|
KNQ|Коне|Коне|
KNR|Канган|Канган|
KNS|Кинг-Айленд|Кинг-Айленд|
KNU|Канпур|Канпур|
KNX|Кунунурра|Кунунурра|
KNZ|Кеньеба|Кеньеба|
KOB|Кутаба|Кутаба|
KOC|Кумак|Кумак|
KOD|Котабангун|Котабангун|
KOG|Кхонг|Кхонг|
KOJ|Кагошима|Кагошима|
KOL|Кумала|Кумала|
KOM|Комо-Манда|Комо-Манда|
KON|Контум|Контум|
KOO|Конголо|Конголо|
KOP|Накхон-Пханом|Накхон Патхом|
KOR|Кокоро|Кокоро|
KOU|Куламуту|Куламуту|
KOV|Кокшетау|Кокшетау|
KOW|Ганчжоу|Ганьчжоу|
KOX|Коконао|Коконао|
KPA|Копьяго|Копьяго|
KPE|Япсией|Япсией|
KPG|Курупунг|Курупунг|
KPM|Компиам|Компиам|
KPO|Пхохан|Пхохан|
KQA|Акутан|Акутан|
KQL|Кол|Кол|
KRF|Крамфорс|Крамфорс|
KRG|Карасабаи|Карасабаи|
KRI|Кикори|Кикори|
KRJ|Каравари|Каравари|
KRK|Краков|Краков|
KRL|Корла|Корла|
KRM|Каранамбо|Каранамбо|
KRN|Кируна|Кируна|
KRO|Курган|Курган|
KRP|Каруп|Каруп|
KRQ|Краматорск|Краматорск|
KRR|Пашковский|Краснодар|
KRS|Кристиансенд|Кристиансенд|
KRT|Хартум|Хартум|
KRV|Керио-Валлей|Керио-Валлей|
KRX|Кар-Кар|Кар-Кар|
KRY|Карамей|Карамай|
KRZ|Кири|Кири|
KSB|Касаномбе|Касаномбе|
KSC|Косице|Косице|
KSD|Карлстад|Карлстад|
KSE|Касесе|Касесе|
KSF|Кассел|Кассел|
KSG|Кисенгам|Кисенгам|
KSH|Керманшах|Керманшах|
KSI|Киссидугу|Киссидугу|
KSK|Карлскуга|Карлскуга|
KSL|Кассала|Кассала|
KSN|Костанай|Костанай|
KSO|Кастория|Кастория|
KSP|Косипе|Косипе|
KSQ|Карши|Карши|
KSS|Сикассо|Сикассо|
KST|Кости|Кости|
KSU|Кистиансанд|Кистиансанд|
KSW|Кирьят-Шемона|Кирьят-Шемона|
KSX|Ясуру|Ясуру|
KSY|Карс|Карс|
KSZ|Котлас|Котлас|
KTA|Каррата|Каррата|
KTE|Кертех|Кертех|
KTF|Такака|Такака|
KTI|Кратье|Кратье|
KTK|Кануа|Кануа|
KTL|Китале|Китале|
KTM|Катманду|Катманду|
KTO|Като|Като|
KTP|Кингстоун|Кингстоун|
KTR|Кэтрин|Кэтрин|
KTT|Киттила|Киттила|
KTU|Кота|Мота|
KTW|Катовице|Катовице|
KTX|Кутиала|Кутиала|
KUA|Куантан|Куантан|
KUC|Куриа|Куриа|
KUE|Кукунди|Кукунди|
KUF|Курумоч|Самара|
KUG|Кубин-Айленд|Кубин-Айленд|
KUH|Куширо|Куширо|
KUI|Кавау-Айленд|Кавау-Айленд|
KUJ|Кушимото|Кушимото|
KUL|Куала-Лумпур|Куала-Лумпур|
KUN|Каунас|Каунас|
KUO|Куопио|Куопио|
KUP|Купиано|Купиано|
KUQ|Кури|Кури|
KUT|Кутаиси|Кутаиси|
KUY|Кугурурок-Ривер, шт. Аляска|Кугурурок-Ривер, шт. Аляска|
KVA|Кавала|Кавала|
KVB|Сковде|Сковде|
KVD|Гянджа|Гянджа|
KVE|Китава|Китава|
KVG|Кавьенг|Кавьенг|
KVK|Кировск|Кировск|
KVU|Королеву|Королеву|
KVX|Киров|Киров|
KWD|Каваджиа|Каваджиа|
KWE|Гуйян|Гуйянг|
KWG|Кривой Рог|Кривой Рог|
KWH|Хвахан|Хвахан|
KWJ|Гванджу|Гванджу|
KWL|Гуйлинь|Гуйлинь|
KWO|Кавито|Кавито|
KWR|Квай-Харбор|Квай-Харбор|
KWU|Мансьон-Хаус|Мансьон-Хаус|
KWV|Курвина|Курвина|
KWX|Киваи-Айленд|Киваи-Айленд|
KWY|Кивайю|Кивайю|
KWZ|Колвези|Колвези|
KXE|Клерксдорп|Клерксдорп|
KXK|Комсомольск на Амуре|Комсомольск на Амуре|
KXR|Карула|Карула|
KYA|Кониа|Конья|
KYD|Орхид-Айленд|Орхид-Айленд|
KYE|Триполи|Триполи|
KYL|Ки Ларго|Ки Ларго|
KYN|Милтон-Кейнес|Милтон-Кейнес|
KYO|Тампа|Тампа|
KYP|Кьяукпью|Кьяукпью|
KYS|Кайес|Кайес|
KYT|Кьяуктау|Кьяуктау|
KYX|Ялумет|Ялумет|
KYZ|Кызыл|Кызыл|
KZD|Кракор|Кракор|
KZF|Каинтиба|Каинтиба|
KZI|Козани|Козани|
KZN|Казань|Казань|
KZO|Кзыл-Орда|Кзыл-Орда|
KZS|Кастелоризо|Кастелоризо|
LAB|Лаблаб|Лаблаб|
LAG|Ла-Гуайра|Ла-Гуайра|
LAH|Лабуха|Лабуха|
LAI|Ланнион|Ланнион|
LAK|Аклавик|Аклавик|
LAN|Лансинг|Лансинг|
LAO|Лаоак|Лаоак|
LAP|Ла Пас|Ла Пас|
LAQ|Бейда|Бейда|
LAS|Лас Вегас|Лас Вегас|
LAV|Лаломалава|Лаломалава|
LAY|Ледисмит|Ледисмит|
LBA|Лидс|Лидс|
LBE|Латроуб|Латроуб|
LBG|Париж|Париж|
LBH|Сидней|Сидней|
LBI|Альби|Альби|
LBJ|Лабуан-Баджо|Лабуан-Баджо|
LBK|Либой|Либой|
LBM|Луабо|Луабо|
LBN|Озеро Баринго|Лейк-Баринго|
LBO|Лусамбо|Лусамбо|
LBQ|Ламбарене|Ламбарене|
LBS|Лабаса|Лабаса|
LBV|Либревилль|Либревилль|
LBY|Сен Назер|Сен Назер|
LCA|Ларнака|Ларнака|
LCC|Лечче|Лечче|
LCD|Луи-Тришар|Луи-Тришар|
LCF|Лас Вегас|Рио Дульче|
LCG|Ла-Коруна|Ла Коруна|
LCJ|Лодзь|Лодзь|
LCL|Ла-Колома|Ла-Колома|
LCR|Ла-Хоррера|Ла-Хоррера|
LCS|Лас-Канас|Лас-Канас|
LCV|Лучча|Лучча|
LCY|Лондон|Лондон|
LDA|Малда|Малда|
LDB|Лондрина|Лондрина|
LDG|Лешуконское|Лешуконское|
LDI|Линди|Линди|
LDK|Лидкопинг|Лидкопинг|
LDN|Ламиданда|Ламиданда|
LDO|Ладуанье|Ладуанье|
LDR|Лодар|Лодар|
LEC|Ленкуа|Ленкуа|
LED|Пулково|Санкт-Петербург|
LEF|Лебакенг|Лебакенг|
LEG|Алег|Алег|
LEH|Ле Хавре|Ле Хавре|
LEI|Альмерия|Алмерия|
LEK|Лабе|Лабе|
LEN|Леон|Леон|
LEO|Лекони|Лекони|
LES|Лесобенг|Лесобенг|
LEV|Бюрета|Бюрета|
LEW|Обурн|Обурн|
LEY|Лелистад|Лелистад|
LFO|Келафо-Каллаф|Келафо-Каллаф|
LFR|Ла-Фриа|Ла-Фриа|
LGA|Нью-Йорк|Нью-Йорк|
LGG|Льеж|Льеж|
LGI|Лонг Айленд|Лонг Айленд|
LGK|Лангкави|Лангкави|
LGL|Лонг-Лелланг|Лонг-Лелланг|
LGM|Лаягам|Лаягам|
LGN|Линга-Линга|Линга-Линга|
LGO|Лангеоог|Лангеоог|
LGQ|Лаго-Агрио|Лаго-Агрио|
LGR|Кочране|Кочране|
LGS|Маларкуэ|Маларкуэ|
LGT|Лас-Гавиотас|Лас-Гавиотас|
LGW|Лондон|Лондон|
LGX|Лю-Ганан|Лю-Ганан|
LGY|Лагуниллас|Лагуниллас|
LGZ|Легизамо|Легизамо|
LHA|Лар|Лар|
LHE|Лахор|Лахор|
LHI|Лерех|Лерех|
LHN|Лишань|Лишань|
LHP|Леху|Леху|
LHR|Хитроу|Лондон|
LHS|Лас-Херас|Лас-Херас|
LHW|Аэропорт Ланчжоу|Ланчжоу|
LIC|Лимон|Лимон|
LID|Лейден|Лейден|
LIE|Либенж|Либенж|
LIG|Лимож|Лимож|
LII|Мулиа|Мулиа|
LIJ|Лонг Айленд|Лонг Айленд|
LIL|Лилль|Лилль|
LIM|Лима|Лима|
LIN|Милан|Милан|
LIO|Лаймон|Лимон|
LIQ|Лисала|Лисала|
LIR|Либерия|Либерия|
LIS|Лиссабон|Лиссабон|
LIW|Лойкау|Лойкау|
LIX|Ликома-Айленд|Ликома-Айленд|
LJA|Лоджа|Лоджа|
LJG|город Лицзян|город Лицзян|
LJU|Любляна|Любляна|
LKA|Ларантука|Ларантука|
LKB|Лакеба|Лакеба|
LKC|Лекана|Лекана|
LKD|Лейклэнд-Даунз|Лейклэнд-Даунз|
LKN|Лекнес|Лекнес|
LKO|Лакнау|Лакнау|
LKP|Лейк Плесид|Лейк Плесид|
LKU|Лейк-Рудольф|Лейк-Рудольф|
LKY|Лейк-Маньяра|Лейк-Маньяра|
LKZ|Брэндон|Брэндон|
LLA|Лули|Лули|
LLE|Малелейн|Малелейн|
LLH|Лас-Лимас|Лас-Лимас|
LLM|Лонг-Лама|Лонг-Лама|
LLN|Келила|Келила|
LLP|Линда-Даунз|Линда-Даунз|
LLS|Лас-Ломитас|Лас-Ломитас|
LMB|Салима|Салима|
LMD|Лос-Менукос|Лос-Менукос|
LME|Ле Манс|Ле Манс|
LMG|Ламасса|Ламасса|
LMH|Лаймон|Лимон|
LMI|Луми|Луми|
LML|Лей-Айленд|Лей-Айленд|
LMM|Лос-Мошис|Лос-Мошис|
LMQ|Марса-Брега|Марса-Брега|
LMR|Лайм-Акрес|Лайм-Акрес|
LMT|Кламмат Фоллз|Кламмат Фоллз|
LMY|Лейк-Мюррей|Лейк-Мюррей|
LMZ|Палма|Палма|
LNA|Уест Палм Бич|Уест Палм Бич|
LNB|Ламен-Бей|Ламен-Бей|
LNC|Ленгбати|Ленгбати|
LNF|Мунбил|Мунбил|
LNG|Лесе|Лесе|
LNM|Лангимар|Лангимар|
LNQ|Лоани|Лоани|
LNX|Смоленск|Смоленск|
LNZ|Линц|Линц|
LOA|Лотарингия|Лотарингия|
LOD|Лонгана|Лонгана|
LOE|Лоэй|Лоэй|
LOF|Лоун|Лоун|
LOK|Лодвар|Лодвар|
LOM|Лагос-де-Морено|Лагос-де-Морено|
LOS|Лагос|Лагос|
LOV|Монклова|Монклова|
LOZ|Лондон|Лондон|
LPB|Ла Пас|Ла Пас|
LPD|Ла-Педрера|Ла-Педрера|
LPE|Ла-Примавера|Ла-Примавера|
LPH|Лохгилпхед|Лохгилпхед|
LPI|Линкопинг|Линкопинг|
LPJ|Пихигуаос|Пихигуаос|
LPK|Липецк|Липецк|
LPL|Ливерпуль|Ливерпуль|
LPM|Ламап|Ламап|
LPP|Лаппенранта|Лаппенранта|
LPQ|Луанг Прабанг|Луанг Прабанг|
LPT|Лампанг|Лампанг|
LPU|Лонг-Апунг|Лонг-Апунг|
LPX|Лиепая|Лиепая|
LPY|Ле-Пуй|Ле-Пуй|
LRA|Лариса|Лариса|
LRB|Лерибе|Лерибе|
LRC|Лаарбух|Лаарбух|
LRD|Ларедо|Ларедо|
LRG|Лора-Лаи|Лора-Лаи|
LRH|Ла Рошель|Ла Рошель|
LRI|Лорика|Лорика|
LRM|Ла-Романа|Ла-Романа|
LRN|Мозес Лейк|Мозес Лейк|
LRS|Лерос|Лерос|
LRT|Лориент|Лориент|
LRV|Лос-Рокес|Лос-Рокес|
LSA|Лосуя|Лосуя|
LSC|Ла Серена|Ла Серена|
LSH|Лашио|Лашио|
LSJ|Лонг Айленд|Лонг Айленд|
LSL|Лос-Чилес|Лос-Чилес|
LSO|Лес-Саблес|Лес-Саблес|
LSP|Лас-Пьедрас|Лас-Пьедрас|
LSQ|Лос Анджелес|Лос Анджелес|
LST|Лончестон|Лончестон|
LSU|Лонг-Суканг|Лонг-Суканг|
LSX|Лхок-Сукон|Лхок-Сукон|
LTA|Цанин|Цанин|
LTB|Латроуб|Латроуб|
LTC|Лей|Лей|
LTD|Гадамес|Гадамес|
LTF|Лейтре|Лейтре|
LTG|Лангтанг|Лангтанг|
LTI|Алтай|Алтай|
LTK|Латакия|Латакия|
LTL|Ластурвилль|Ластурвилль|
LTM|Летем|Летем|
LTO|Лорето|Лорето|
LTP|Линдхерст|Линдхерст|
LTR|Леттеркенни|Леттеркенни|
LUA|Лукла|Лукла|
LUB|Лумид-Пау|Лумид-Пау|
LUD|Людериц|Людериц|
LUE|Лученец|Лученец|
LUF|Феникс|Феникс|
LUG|Лугано|Лугано|
LUH|Лудхиана|Лудхиана|
LUI|Ла-Унион|Ла-Унион|
LUJ|Лусикисики|Лусикисики|
LUM|Луси|Луси|
LUQ|Сан-Луис|Сан-Луис|
LUS|Лусанга|Лусанга|
LUW|Лувук|Лувук|
LUX|Люксембург|Люксембург|
LVA|Лаваль|Лаваль|
LVI|Ливингстоун|Ливингстоун|
LVM|Ливингстон|Ливингстон|
LVS|Лас Вегас|Лас Вегас|
LWE|Леволеба|Леволеба|
LWI|Ловай|Ловай|
LWO|Скнилов|Львов|
LWR|Леуварден|Лиуварден|
LXG|Луанг-Намтха|Луанг-Намтха|
LXR|Луксор|Луксор|
LXU|Лукулу|Лукулу|
LYA|Люян|Люян|
LYC|Ликселе|Ликселе|
LYG|Лианьюнан|Лианьюнан|
LYH|Линчбург|Линчбург|
LYK|Луньюк|Луньюк|
LYN|Лион|Лион|
LYP|Фейсалабад|Фейсалабад|
LYR|Лонгербьен|Лонгербьен|
LYS|Лион|Лион|
LZA|Луиза|Луиза|
LZC|Лацаро-Карденас|Лацаро-Карденас|
LZD|Ланчжоу|Ланчжоу|
LZH|Лучжоу|Лучжоу|
LZI|Луози|Луози|
LZO|Лужчоу|Лужчоу|
LZR|Лизард Айленд|Лизард Айленд|
MAC|Макон|Макон|
MAD|Мадрид|Мадрид|
MAF|Мидленд|Мидленд|
MAG|Маданг|Маданг|
MAI|Мангочи|Мангочи|
MAK|Малакал|Малакал|
MAL|Манголе|Манголе|
MAM|Матаморос|Матаморос|
MAN|Манчестер|Манчестер|
MAO|Манаус|Манаус|
MAP|Мамаи|Мамаи|
MAQ|Мей-Сот|Мае Сот|
MAR|Маракайбо|Маракайбо|
MAT|Матади|Матади|
MAX|Матам|Матам|
MAY|Менгров-Кэй|Менгров-Кэй|
MBA|Момбаса|Момбаса|
MBC|Мбигу|Мбигу|
MBE|Монбецу|Монбецу|
MBI|Мбея|Мбея|
MBJ|Монтего Бей|Монтего Бей|
MBK|Матупа|Матупа|
MBM|Мкамбати|Мкамбати|
MBO|Мамбурао|Мамбурао|
MBP|Мойобамба|Мойобамба|
MBQ|Мбарара|Мбарара|
MBR|Мбаут|Мбаут|
MBT|Масбате|Масбате|
MBU|Мбамбанакира|Мбамбанакира|
MBV|Маса|Маса|
MBX|Марибор|Марибор|
MCA|Масента|Масента|
MCC|Сакраменто|Сакраменто|
MCE|Мерсед|Мерсед|
MCF|Тампа|Тампа|
MCH|Мачала|Мачала|
MCI|Канзас Сити|Канзас Сити|
MCJ|Маикао|Маикао|
MCM|Монте-Карло|Монте-Карло|
MCN|Макон|Макон|
MCQ|Мискольц|Мискольц|
MCT|Мускат|Мускат|
MCU|Монлукон|Монлукон|
MCX|Уйташ|Махачкала|
MCY|Марухидор|Марухидор|
MCZ|Масейо|Масейо|
MDB|Мелинда|Мелинда|
MDC|Манадо|Манадо|
MDD|Мидленд|Мидленд|
MDE|Меделлин|Меделлин|
MDG|Муданцзян|Муданьцзян|
MDI|Макурди|Макурди|
MDK|Мбандака|Мбандака|
MDL|Мандалай|Мандалай|
MDM|Мундуку|Мундуку|
MDP|Миндиптана|Миндиптана|
MDS|Миддл-Кайкос|Миддл-Кайкос|
MDU|Менди|Менди|
MDV|Медунеу|Медунеу|
MDW|Чикаго|Чикаго|
MDX|Мерседес|Мерседес|
MDZ|Мендоса|Мендоса|
MEB|Мельбурн|Мельбурн|
MEF|Мелфи|Мелфи|
MEH|Мехамн|Мехамн|
MEI|Меридиан|Меридиан|
MEK|Мекнес|Мекнес|
MEL|Мельбурн|Мельбурн|
MEM|Мемфис|Мемфис|
MEN|Менде|Менде|
MEP|Мерсинг|Мерсинг|
MEQ|Меулабох|Меулабох|
MES|Медан|Медан|
MEU|Монте-Дурадо|Монте-Дурадо|
MEW|Мвека|Мвека|
MEX|Мексико Сити|Мексико Сити|
MEY|Мегхаули|Мегхаули|
MEZ|Мессина|Мессина|
MFB|Монфорт|Монфорт|
MFC|Мафетенг|Мафетенг|
MFF|Моанда|Моанда|
MFG|Музаффарабад|Музаффарабад|
MFJ|Моала|Моала|
MFM|Макао|Макао|
MFN|Милфорд Саунд|Милфорд Саунд|
MFQ|Маради|Маради|
MFS|Мирафлорес|Мирафлорес|
MFT|Мачу-Пиччу|Мачу-Пиччу|
MFU|Мфуве|Мфуве|
MFX|Мерибель|Мерибел|
MGD|Магдалена|Магдалена|
MGH|Маргейт|Маргейт|
MGN|Баракоа|Баракоа|
MGP|Манга|Манга|
MGQ|Могадишо|Могадишо|
MGU|Манаунг|Манаунг|
MGV|Маргарет Ривер|Маргарет Ривер|
MGX|Моаби|Моаби|
MHA|Махдия|Мадиа|
MHB|Окленд|Окленд|
MHD|Машад|Машад|
MHE|Митчелл|Митчелл|
MHF|Морихал|Морихал|
MHG|Маннхайм|Маннхайм|
MHI|Муша|Муша|
MHL|Маршалл|Маршалл|
MHP|Минск 1|Минск|
MHQ|Мариехамн|Мариехамн|
MHT|Манчестер|Манчестер|
MHX|Манихики-Айленд|Манихики-Айленд|
MHY|Морехед|Морехед|
MHZ|Милденхолл|Милденхолл|
MIA|Международный Аэропорт Майами|Майами|
MIC|Миннеаполис|Миннеаполис|
MID|Мериба|Мериба|
MIH|Митчелл-Плато|Митчелл-Плато|
MIK|Миккели|Миккели|
MIM|Меримбула|Меримбула|
MIO|Майами|Майами|
MIR|Монастир|Монастир|
MIU|Майдугури|Майдугури|
MIX|Мирити|Мирити|
MJA|Мандза|Мандза|
MJE|Меджкин|Меджкин|
MJF|Мосьоэн|Мосьоэн|
MJH|Маджма|Маджма|
MJJ|Моки|Моки|
MJK|Монки Миа|Монки Миа|
MJL|Муила|Муила|
MJQ|Джексон|Джексон|
MJR|Мирамар|Мирамар|
MJU|Мамую|Мамую|
MJV|Сан-Хавьер|Мурсия|
MJY|Мангунджая|Мангунджая|
MJZ|Мирный|Мирный|
MKA|Марианские Лазнe|Марианские Лазнe|
MKB|Мекамбо|Мекамбо|
MKC|Канзас Сити|Канзас Сити|
MKE|Милуоки|Милуоки|
MKH|Мохотлонг|Мохотлонг|
MKJ|Макуа|Макуа|
MKL|Джексон|Джексон|
MKN|Малеколон|Малеколон|
MKP|Макемо|Макемо|
MKU|Макоку|Макоку|
MKW|Маноквари|Маноквари|
MKX|Мукалла|Мукалла|
MKY|Маккей|Маккей|
MKZ|Малакка|Малакка|
MLB|Мельбурн|Мельбурн|
MLE|Мале|Мале|
MLF|Милфорд|Милфорд|
MLG|Маланг|Маланг|
MLK|Мальта|Мальта|
MLL|Маршалл|Маршалл|
MLM|Морелия|Морелия|
MLN|Мелийя|Мелилья|
MLO|Милос|Милос|
MLP|Малабанг|Малабанг|
MLQ|Малалауа|Малалауа|
MLU|Монро|Монро|
MLX|Малатия|Малатия|
MLZ|Мело|Мело|
MMB|Меманбецу|Меманбецу|
MMC|Сиудад-Манте|Сиудад-Манте|
MMF|Мамфе|Мамфе|
MMH|Маммот Лейкс|Маммот Лейкс|
MMI|Афины|Афины|
MMJ|Мацумото|Матсумото|
MMK|Мурманск|Мурманск|
MML|Маршалл|Маршалл|
MMR|Остин|Остин|
MMT|Колумбия|Колумбия|
MMW|Мома|Мома|
MMX|Малмо|Малмо|
MMZ|Меймене|Меймене|
MNA|Меланггуане|Меланггуане|
MNB|Моанда|Моанда|
MNC|Накала|Накала|
MNF|Остров Мана|Остров Мана|
MNH|Миннерия|Миннерия|
MNJ|Манандзари|Манандзари|
MNK|Миайана|Миайана|
MNO|Маноно|Маноно|
MNP|Марон|Марон|
MNR|Монгу|Монгу|
MNS|Манса|Манса|
MNV|Маунтейн-Веллей|Маунтейн-Веллей|
MNY|Моно|Моно|
MNZ|Манассас|Манассас|
MOA|Моа|Моа|
MOB|Алабама|Алабама|
MOE|Момейк|Момейк|
MOF|Маумере|Маумере|
MOH|Моханбари|Моханбари|
MOL|Молде|Молде|
MOM|Мауджерия|Мауджерия|
MON|Маунт Кук|Маунт Кук|
MOO|Мумба|Мумба|
MOP|Маунт-Плезант|Маунт-Плезант|
MOQ|Морондава|Морондава|
MOY|Монтеррей|Монтеррей|
MPA|Мпача|Мпача|
MPB|Майами|Майами|
MPD|Мирпур-Хас|Мирпур-Хас|
MPF|Мапода|Мапода|
MPG|Макини|Макини|
MPH|Катиклан|Катиклан|
MPI|Мамитупо|Мамитупо|
MPK|Мокпо|Мокпо|
MPL|Монпейе|Монпейе|
MPM|Мапуту|Мапуту|
MPN|Маунт-Плезант|Маунт-Плезант|
MPQ|Маан|Маан|
MPS|Маунт-Плезант|Маунт-Плезант|
MPT|Малиана|Малиана|
MPU|Мапуа|Мапуа|
MPW|Мариуполь|Мариуполь|
MPX|Миянмин|Миянмин|
MPY|Марипасула|Марипасула|
MQC|Микелон|Микелон|
MQD|Макинчао|Макинчао|
MQF|Магнитогорск|Магнитогорск|
MQH|Минаку|Минаку|
MQI|Куинси|Куинси|
MQJ|Балыкесир|Балыкесир|
MQL|Мильдура|Мильдура|
MQM|Мардин|Мардин|
MQP|Нельспрут|Нельспрут|
MQQ|Мунду|Мунду|
MQR|Москера|Москера|
MQS|Мистик-Айленд|Мистик-Айленд|
MQU|Марикита|Марикита|
MQX|Макале|Макале|
MQZ|Маргарет Ривер|Маргарет Ривер|
MRA|Мисурата|Мисурата|
MRC|Колумбия|Колумбия|
MRD|Мериба|Мериба|
MRE|Мара-Лоджес|Мара-Лоджес|
MRH|Мей-Ривер|Мей-Ривер|
MRI|Анкораж|Анкораж|
MRJ|Маркала|Маркала|
MRK|Марко Айленд|Марко Айленд|
MRL|Майнерз-Лейк|Майнерз-Лейк|
MRM|Манаре|Манаре|
MRO|Мастертон|Мастертон|
MRQ|Мариндюк|Мариндюк|
MRS|Марсель|Марсель|
MRV|Минеральные Воды|Минеральные Воды|
MRY|Монтерей|Монтерей|
MRZ|Мори|Мори|
MSC|Меса|Меса|
MSG|Матсайле|Матсайле|
MSH|Масирах|Масирах|
MSI|Масалембо|Масалембо|
MSJ|Мисава|Мисава|
MSK|Мастик-Пойнт|Мастик-Пойнт|
MSL|Шеффилд|Шеффилд|
MSM|Маси-Манимба|Маси-Манимба|
MSP|Миннеаполис|Миннеаполис|
MSQ|Национальный аэропорт Минск|Минск|
MSR|Муш|Муш|
MST|Маастрихт|Маастрихт|
MSW|Массава|Массава|
MTA|Матамата|Матамата|
MTB|Монте-Либано|Монте-Либано|
MTF|Мизан-Тефери|Мизан-Тефери|
MTH|Марафон|Марафон|
MTI|Мостейрос|Мостейрос|
MTL|Мейтленд|Мейтленд|
MTN|Балтимор|Балтимор|
MTQ|Митчелл|Митчелл|
MTR|Монтериа|Монтериа|
MTT|Минатитлан|Минатитлан|
MTU|Монтепуэс|Монтепуэс|
MTV|Мота-Лава|Мота-Лава|
MTY|Монтеррей|Монтеррей|
MTZ|Масада|Масада|
MUB|Мон|Мон|
MUC|Мюнхен|Мюнхен|
MUF|Мутинг|Мутинг|
MUG|Мулеж|Мулеж|
MUJ|Муи|Муи|
MUM|Мумиас|Мумиас|
MUN|Матурин|Матурин|
MUV|Филадельфия|Филадельфия|
MUW|Маскара|Маскара|
MUX|Мултан|Мултан|
MUY|Муйондзи|Муйондзи|
MUZ|Мусома|Мусома|
MVA|Миватн|Миватн|
MVD|Монтевидео|Монтевидео|
MVG|Меван|Меван|
MVI|Манетай|Манетай|
MVJ|Мандевилль|Мандевилль|
MVL|Стоув|Стоув|
MVM|Моньюмент Вэлли|Моньюмент Вэлли|
MVO|Монго|Монго|
MVP|Миту|Миту|
MVQ|Могилев|Могилев|
MVT|Матайва|Матайва|
MVV|Мегев|Межев|
MVX|Минвул|Минвул|
MVZ|Масвинго|Масвинго|
MWC|Милуоки|Милуоки|
MWD|Мьанвали|Мьанвали|
MWE|Мерове|Мерове|
MWF|Мево|Мево|
MWG|Маравака|Маравака|
MWH|Мозес Лейк|Мозес Лейк|
MWI|Марамуни|Марамуни|
MWJ|Маттьюс-Ридж|Маттьюс-Ридж|
MWK|Матак|Матак|
MWN|Мвадуй|Мвадуй|
MWP|Маунтин|Маунтин|
MWQ|Магуэ|Магуэ|
MWU|Муссау|Муссау|
MWZ|Мванза|Мванза|
MXB|Масамба|Масамба|
MXG|Марлборо|Марлборо|
MXI|Мати|Мати|
MXJ|Минна|Минна|
MXK|Миндик|Миндик|
MXM|Моромбе|Моромбе|
MXP|Милан|Милан|
MXQ|Митчелл-Ривер|Митчелл-Ривер|
MXR|Миргород|Миргород|
MXT|Майнтирано|Майнтирано|
MXX|Мора|Мора|
MXZ|Мейсян|Мейсян|
MYB|Маюмба|Маюмба|
MYC|Маракай|Маракай|
MYD|Малинди|Малинди|
MYE|Мияке-Жима|Мияке-Жима|
MYF|Сан Диего|Сан Диего|
MYJ|Мацуяма|Мацуяма|
MYM|Манки-Маунтин|Манки-Маунтин|
MYN|Мариб|Мариб|
MYO|Майруда|Майруда|
MYQ|Майсор|Майсор|
MYR|Миртл Бич|Миртл Бич|
MYS|Мояль|Мояль|
MYT|Мьиткьина|Мьиткьина|
MYW|Мтвара|Мтвара|
MYX|Меньямья|Меньямья|
MYY|Мири|Мири|
MZA|Музаффарнагар|Музаффарнагар|
MZC|Мицик|Мицик|
MZD|Мендес|Мендес|
MZE|Манати|Манати|
MZG|Макунг|Макунг|
MZH|Мерзифон|Мерзифон|
MZK|Маракеи|Маракеи|
MZL|Манисалес|Манисалес|
MZM|Мец|Мец|
MZN|Миндж|Миндж|
MZO|Манзанилло|Манзанилло|
MZP|Мотуэка|Мотуэка|
MZQ|Мкуз|Мкуз|
MZS|Мостин|Мостин|
MZT|Мазатлан|Мазатлан|
MZU|Музаффарпур|Музаффарпур|
MZX|Мена|Мена|
MZY|Залив Моссел|Залив Моссел|
NAB|Олбани NAS|Олбани|
NAD|Маканал|Маканал|
NAE|Натитингу|Натитингу|
NAF|Банаина|Банаина|
NAG|Нагпур|Нагпур|
NAI|Аннаи|Аннаи|
NAJ|Нахичевань|Нахичевань|
NAK|Накхон Ратчасима|Натхон Ратчасима|
NAL|Нальчик|Нальчик|
NAM|Намлеа|Намлеа|
NAN|Фиджи-Нади|Фиджи-Нади|
NAO|Наньчон|Наньчон|
NAR|Наре|Наре|
NAT|Наталь|Наталь|
NAV|Невсехир|Невсехир|
NAW|Наратхиват|Наративат|
NAY|Пекин|Пекин|
NBB|Барранкоминас|Барранкоминас|
NBC|Набережные Челны|Набережные Челны|
NBG|Новый Орлеан|Новый Орлеан|
NBH|Намбука Хэдс|Намбука Хэдс|
NBL|Сан-Блас|Сан-Блас|
NBO|Найроби|Найроби|
NBP|Нью-Йорк|Нью-Йорк|
NBW|Гуантанамо|Гуантанамо|
NBX|Набире|Набире|
NCA|Норт-Кайкос|Норт-Кайкос|
NCH|Начингвеа|Начингвеа|
NCI|Некокли|Некокли|
NCL|Ньюкасл|Ньюкасл|
NCR|Сан Карлос|Сан Карлос|
NCS|Ньюкасл|Ньюкасл|
NCT|Гуанакасте|Никоя|
NCU|Нукус|Нукус|
NCY|Аннеси|Аннеси|
NDA|Банданаира|Банданаира|
NDB|Нуакдибу|Нуакдибу|
NDC|Нандед|Нандед|
NDD|Сумбе|Сумбе|
NDE|Мандера|Мандера|
NDG|Цицихар|Цицихар|
NDI|Намиди|Намиди|
NDL|Нделе|Нделе|
NDM|Менди|Менди|
NDR|Надор|Надор|
NDU|Рунду|Рунду|
NEC|Некочеа|Некочеа|
NEF|Нефтекамск|Нефтекамск|
NEG|Негриль|Негрил|
NER|Нерюнгри|Нерюнгри|
NES|Нью-Йорк|Нью-Йорк|
NEV|Ньюкасл|Ньюкасл|
NEW|Новый Орлеан|Новый Орлеан|
NFG|Нефтеюганск|Нефтеюганск|
NGB|Нинбо|Нинбо|
NGD|Анегада|Анегада|
NGM|Агана|Агана|
NGN|Наргана|Наргана|
NGP|Корпус Кристи|Корпус Кристи|
NGS|Нагасаки|Нагасаки|
NGW|Корпус Кристи|Корпус Кристи|
NGX|Мананг|Мананг|
NHA|Нха Транг|Нха Транг|
NHF|Нью-Халфа|Нью-Халфа|
NHS|Нушки|Нушки|
NIA|Нимба|Нимба|
NIC|Никозия|Никозия|
NIG|Никунау|Никунау|
NIK|Ниоколо-Коба|Ниоколо-Коба|
NIM|Ниамей|Ниамей|
NIO|Ниоки|Ниоки|
NIT|Ниорт|Ниорт|
NIX|Ниоро|Ниоро|
NJA|Ацуги|Ацуги|
NJC|Нижневартовск|Нижневартовск|
NKA|Нкан|Нкан|
NKC|Нуакшот|Нуакшот|
NKL|Нколо|Нколо|
NKM|Нагойя|Нагойя|
NKN|Нанкина|Нанкина|
NKU|Нкаус|Нкаус|
NKX|Сан Диего|Сан Диего|
NKY|Нкайи|Нкайи|
NLK|Норфолк Айленд|Норфолк Айленд|
NLP|Нельспрут|Нельспрут|
NLU|Синоп|Синоп|
NLV|Николаев|Николаев|
NMA|Наманган|Наманган|
NMB|Даман|Даман|
NMG|Сан-Мигель|Сан-Мигель|
NMS|Намсанг|Намсанг|
NMT|Намту|Намту|
NMU|Наму|Наму|
NNA|Кенитра|Кенитра|
NNB|Санта-Ана|Санта-Ана|
NND|Нангаде|Нангаде|
NNG|Наньнин|Наньнин|
NNI|Намутони|Намутони|
NNM|Нарян-Мар|Нарьян-Мар|
NNT|Нан|Нан|
NNX|Нунукан|Нунукан|
NNY|Наньян|Наньян|
NOB|Носара-Бич|Носара-Бич|
NOC|Нок|Нок|
NOD|Норден|Норден|
NOE|Норддайх|Норддайх|
NOG|Ногалес|Ногалес|
NOH|Чикаго|Чикаго|
NOI|Крымск|Новороссийск|
NOJ|Ноябрьск|Ноябрьск|
NOK|Нова-Шавантина|Нова-Шавантина|
NOM|Номад-Ривер|Номад-Ривер|
NON|Нонути|Нонути|
NOO|Наоро|Наоро|
NOR|Нордфьордур|Нордфьордур|
NOZ|Новокузнецк|Новокузнецк|
NPE|Напье-Хастингс|Напье-Хастингс|
NPG|Нипа|Нипа|
NPL|Нью Плимут|Нью-Плимут|
NPO|Нангапинох|Нангапинох|
NQN|Неукен|Неукен|
NQU|Нуки|Нуки|
NQX|Ки Уэст|Ки Уэст|
NRD|Нордерней|Нордерней|
NRK|Ноггкопинг|Ноггкопинг|
NRM|Нара|Нара|
NRN|Дюссельдорф|Дюссельдорф|
NRT|Токио|Токио|
NRV|Гуам|Гуам|
NSA|Нуса|Нуса|
NSI|Яунде|Яунде|
NSN|Нельсон|Нельсон|
NSP|Сангли-Пойнт|Сангли-Пойнт|
NST|Након-Си-Таммарат|Након-Си-Таммарат|
NSY|Токат|Токат|
NTA|Натадола|Натадола|
NTB|Нутодден|Нутодден|
NTC|Санта-Каролина|Санта-Каролина|
NTE|Нант|Нант|
NTG|Наньтун|Наньтун|
NTI|Бинтуни|Бинтуни|
NTL|Ньюкасл|Ньюкасл|
NTO|Санто-Антао|Санто-Антао|
NTR|Тингрела|Тухтла-Гутьеррес|
NTT|Ниуатопутапу|Ниуатопутапу|
NTX|Натуна-Ранай|Натуна-Ранай|
NTY|Сан Сити|Сан Сити|
NUD|Эн-Нахуд|Эн-Нахуд|
NUG|Нугуриа|Нугуриа|
NUH|Нунчиа|Нунчиа|
NUS|Норсуп|Норсуп|
NUT|Нутуве|Нутуве|
NUU|Накуру|Накуру|
NUX|Новый Уренгой|Новый Уренгой|
NVA|Нейва|Нейва|
NVG|Нуэва-Гуинея|Нуэва-Гуинея|
NVI|Навой|Навой|
NVK|Нарвик|Нарвик|
NVP|Ново-Арипуана|Ново-Арипуана|
NVR|Новогород|Новгород|
NVS|Неверс|Неверс|
NVT|Навегантес|Навегантес|
NVY|Нейвели|Нейвели|
NWA|Моэли|Моэли|
NWI|Норвич|Норвич|
NWS|Нью-Йорк|Нью-Йорк|
NWT|Новата|Новата|
NYE|Ньери|Ньери|
NYI|Суньяни|Суньяни|
NYK|Нануки|Нануки|
NYM|Надым|Надым|
NYO|Стокгольм|Стокгольм|
NZO|Нзоя|Нзоя|
NZY|Сан Диего|Сан Диего|
OAG|Орандж|Орандж|
OAM|Оамару|Оамару|
OAN|Оланчито|Оланчито|
OAX|Оксака|Оксака|
OBA|Обан|Обан|
OBC|Обок|Обок|
OBD|Обано|Обано|
OBI|Обидос|Обидос|
OBM|Моропе|Моропе|
OBN|Обан|Обан|
OBO|Обихиро|Обихиро|
OBS|Обенас|Обенас|
OBX|Обо|Обо|
OCC|Кока|Кока|
OCF|Окала|Окала|
OCJ|Очо Риос|Очо Риос|
OCN|Оушнсайд|Оушнсайд|
OCV|Окана|Окана|
ODA|Уадда|Уадда|
ODB|Кордова|Кордова|
ODE|Оденсе|Оденсе|
ODJ|Уанда-Джалле|Уанда-Джалле|
ODS|Одесса|Одесса|
ODY|Удомхей|Удомхей|
OEA|Винсенн|Винсенн|
OEC|Окусси|Окусси|
OEL|Орел|Орел|
OEM|Паломеу|Паломеу|
OER|Орнсколдсвик|Орнсколдсвик|
OFJ|Олаффьордур|Олаффьордур|
OGD|Огден|Огден|
OGE|Огерананг|Огерананг|
OGL|Огле|Огле|
OGN|Йонагуни-Жима|Йонагуни-Жима|
OGR|Бонгор|Бонгор|
OGX|Уаргла|Уаргла|
OGZ|Беслан|Владикавказ|
OHD|Охрид|Охрид|
OHI|Ошакати|Ошакати|
OHO|Охотск|Охотск|
OHP|Обан|Обан|
OHT|Кохат|Кохат|
OIC|Норвич|Норвич|
OIR|Окусири|Окусири|
OIT|Оита|Оита|
OJC|Канзас Сити|Канзас Сити|
OKA|Окинава|Окинава|
OKB|Фрейзер Айленд|Орхид-Бич|
OKC|Оклахома Сити|Оклахома Сити|
OKD|Саппоро|Саппоро|
OKE|Окино-Эрабу|Окино-Эрабу|
OKF|Окаукуйэхо|Окаукуйэхо|
OKG|Окойо|Окойо|
OKI|Оки-Айленд|Оки-Айленд|
OKJ|Окаяма|Окаяма|
OKL|Оксибил|Оксибил|
OKN|Оконджа|Оконджа|
OKO|Токио|Токио|
OKP|Оксапмин|Оксапмин|
OKQ|Окаба|Окаба|
OKT|Октябрьский|Октябрьский|
OLA|Орланд|Орланд|
OLI|Олафсвик|Олафсвик|
OLJ|Олпой|Олпой|
OLM|Олимпия|Олимпия|
OLO|Оломоуц|Оломоуц|
OLQ|Олсобип|Олсобип|
OLS|Ногалес|Ногалес|
OMA|Омаха|Омаха|
OMB|Омбуэ|Омбуэ|
OMC|Ормок|Ормок|
OMD|Ораньемунд|Ораньемунд|
OMG|Омега|Омега|
OMH|Урмиех|Урмиех|
OMJ|Омура|Омура|
OML|Омкалай|Омкалай|
OMM|Мармул|Мармул|
OMN|Османабад|Османабад|
OMO|Мостар|Мостар|
OMR|Орадеа|Орадя|
OMS|Омск|Омск|
ONB|Ононге|Ононге|
OND|Ондангва|Ондангва|
ONI|Моанамани|Моанамани|
ONQ|Зонгулдаг|Зонгулдаг|
ONU|Оно-И-Лау|Оно-И-Лау|
ONX|Колон|Колон|
OOM|Коома|Коома|
OOT|Онотоа|Онотоа|
OPA|Копаскер|Копаскер|
OPB|Опен-Бей|Опен-Бей|
OPF|Майами|Майами|
OPO|Порто|Порто|
OPS|Синоп|Синоп|
OPU|Балимо|Балимо|
OPW|Опува|Опува|
ORA|Оран|Оран|
ORB|Оребро|Оребро|
ORC|Ороке|Ороке|
ORE|Орлеан|Орлеан|
ORJ|Ориндук|Ориндук|
ORK|Корк|Корк|
ORL|Орландо|Орландо|
ORN|Оран|Оран|
ORO|Йоро|Йоро|
ORP|Орапа|Орапа|
ORU|Оруро|Оруро|
ORW|Ормара|Ормара|
ORY|Париж|Париж|
ORZ|Ориндж-Уолк|Ориндж-Уолк|
OSD|Остерсанд|Остерсанд|
OSE|Омора|Омора|
OSI|Осиек|Осиек|
OSK|Оскархамн|Оскархамн|
OSL|Осло|Осло|
OSM|Мосул|Мосул|
OSP|Слупск|Слупск|
OSR|Острава|Острава|
OSS|Ош|Ош|
OSW|Орск|Орск|
OSY|Намсус|Намсус|
OSZ|Кошалин|Кошалин|
OTC|Бол|Бол|
OTD|Контадора|Контадора|
OTI|Моротаи-Айленд|Моротаи-Айленд|
OTJ|Отьиваронго|Отьиваронго|
OTL|Бутилимит|Бутилимит|
OTP|Бухарест|Бухарест|
OTR|Кото-47|Кото-47|
OTU|Оту|Оту|
OTY|Ориа|Ориа|
OUA|Уагадугу|Уагадугу|
OUD|Уджда|Уджда|
OUE|Уэссо|Уэссо|
OUG|Уахигоуя|Уахигоуя|
OUH|Оудсхорн|Оудсхорн|
OUL|Оулу|Оулу|
OUR|Батури|Батури|
OUT|Буссо|Буссо|
OUZ|Зурате|Зурате|
OVA|Бекили|Бекили|
OVB|Толмачево|Новосибирск|
OVD|Астурия|Астурия|
OVL|Овайе|Овайе|
OWE|Овендо|Овендо|
OXF|Оксфорд|Оксфорд|
OXR|Вентура|Вентура|
OYA|Гоя|Гоя|
OYE|Оем|Оем|
OYG|Мойо|Мойо|
OYL|Мояль|Мояль|
OYO|Трес-Арройос|Трес-Арройос|
OZC|Озамис-Сити|Озамис-Сити|
OZH|Запорожье|Запорожье|
OZZ|Уарзазат|Уазазат|
PAB|Биласпур|Биласпур|
PAC|Панама Сити|Панама Сити|
PAE|Эверетт|Эверетт|
PAF|Пакуба|Пакуба|
PAG|Пагадиан|Пагадиан|
PAI|Пайлинь|Пайлинь|
PAJ|Пара-Чинар|Пара-Чинар|
PAL|Паланкеро|Паланкеро|
PAM|Панама Сити|Панама Сити|
PAN|Паттани|Паттани|
PAO|Пало Альто|Пало Альто|
PAS|Парос|Парос|
PAT|Патна|Патна|
PAU|Паук|Паук|
PAW|Памбва|Памбва|
PAZ|Поса-Рика|Поса-Рика|
PBD|Порбандар|Порбандар|
PBE|Пуэрто-Беррио|Пуэрто-Беррио|
PBH|Паро|Паро|
PBI|Уест Палм Бич|Уест Палм Бич|
PBJ|Паама|Паама|
PBN|Порту-Амбоим|Порту-Амбоим|
PBR|Пуэрто Барриос|Пуэрто Барриос|
PBS|Патонг-Бич|Патонг-Бич|
PBU|Путао|Путао|
PBW|Палибело|Палибело|
PBZ|Плеттенберг Бей|Плеттенберг-Бей|
PCB|Пондок-Кабе|Джакарта|
PCC|Пуэрто Рико|Пуэрто Рико|
PCG|Пасо-Кабаллос|Пасо-Кабаллос|
PCH|Палачос|Палачос|
PCL|Пукальпа|Пукальпа|
PCN|Пиктон|Пиктон|
PCO|Пунта-Колораде|Пунта-Колораде|
PCR|Пуэрто-Каррено|Пуэрто-Каррено|
PCV|Пунта-Шивато|Пунта-Шивато|
PDA|Пуэрто-Инирида|Пуэрто-Инирида|
PDC|Муэо|Муэо|
PDF|Прадо|Прадо|
PDG|Паданг|Паданг|
PDI|Пиндиу|Пиндиу|
PDO|Пендопо|Пендопо|
PDR|Президенти-Дутра|Президенти-Дутра|
PDS|Пьедрас-Неграс|Пьедрас-Неграс|
PDU|Пайсанду|Пайсанду|
PDV|Пловдив|Пловдив|
PDZ|Педерналес|Педерналес|
PEB|Пебане|Пебане|
PED|Пардубицы|Пардубицы|
PEE|Большое Савино|Пермь|
PEG|Перужия|Перужия|
PEK|Пекин|Пекин|
PEL|Пеланенг|Пеланенг|
PEM|Пуэрто Мальдонадо|Пуэрто Мальдонадо|
PEN|Пенанг|Пенанг|
PER|Перт|Перт|
PES|Петрозаводск|Петрозаводск|
PEW|Пешавар|Пешавар|
PEX|Печора|Печора|
PEZ|Пенза|Пенза|
PFJ|Патрексфьордур|Патрексфьордур|
PFN|Панама Сити|Панама Сити|
PFO|Пафос|Пафос|
PFR|Илебо|Илебо|
PGA|Паг|Паг|
PGB|Пангоа|Пангоа|
PGC|Петерсбург|Петерсбург|
PGD|Пунта-Горда|Пунта-Горда|
PGE|Егепа|Егепа|
PGF|Перпиньян|Перпиньян|
PGG|Прогрессо|Сао Паоло|
PGH|Пантнагар|Пантнагар|
PGK|Пангкалпинанг|Пангкалпинанг|
PGN|Пангиа|Пангиа|
PGO|Пагоса Спрингз|Пагоса Спрингз|
PGP|Порто Алегре|Порто Алегре|
PGX|Периге|Периге|
PHA|Пхань-Ранг|Пхань-Ранг|
PHH|Фан Тиет|Пхань-Тхиет|
PHL|Филадельфия|Филадельфия|
PHM|Беблинген|Беблинген|
PHS|Пхитсанулок|Пхитсанусок|
PHT|Париж|Париж|
PHU|Пху-Винх|Пху-Винх|
PHW|Кейптаун|Фалаборва|
PHX|Феникс|Феникс|
PHY|Пхетчабун|Пхетчабун|
PHZ|Остров Пхи Пхи|Остров Пхи Пхи|
PIC|Пайн-Кей|Пайн-Кей|
PIE|Клируотер|Клируотер|
PIG|Питинга|Питинга|
PIL|Пилар|Пилар|
PIO|Писко|Писко|
PIQ|Пипиллипаи|Пипиллипаи|
PIS|Пуатье|Пуатье|
PIU|Пиуро|Пиуро|
PIZ|Пойнт-Лей LRRS|Пойнт-Лей LRRS|
PJC|Педро-Хуан-Кабальеро|Педро-Хуан-Кабальеро|
PJG|Панджгур|Панджгур|
PJM|Пуэрто-Хименес|Пуэрто-Хименес|
PJZ|Пуэрто Ваярта|Пуэрто-Хуарес|
PKB|Паркерсбург|Паркерсбург|
PKC|Елизово|Петропавловск-Камчатский|
PKE|Паркес|Паркес|
PKJ|Плайа Гранде|Плайа Гранде|
PKK|Пакокку|Пакокку|
PKL|Пакатоа-Айленд|Пакатоа-Айленд|
PKM|Порт-Каитума|Порт-Каитума|
PKN|Пангкаланбуун|Пангкаланбуун|
PKO|Параку|Параку|
PKR|Покхара|Покхара|
PKS|Паксан|Паксан|
PKU|Пеканбару|Пеканбару|
PKV|Псков|Псков|
PKZ|Паксе|Паксе|
PLA|Планадас|Планадас|
PLC|Планета-Рико|Планета-Рико|
PLD|Плая-Самара|Плайя Самара|
PLE|Пайела|Пайела|
PLF|Пала|Пала|
PLG|Ла Плань|Ла-Планье|
PLI|Палм Айленд|Пам-Айленд|
PLM|Палембанг|Палембанг|
PLP|Ля Пальма|Ля Пальма|
PLT|Плато|Плато|
PLU|Бело Хоризонте|Бело Хоризонте|
PLV|Полтава|Полтава|
PLX|Семипалатинск|Семипалатинск|
PLZ|Порт Элизабет|Порт Элизабет|
PMC|Пуэрто Монт|Пуэрто Монт|
PME|Портсмут|Портсмут|
PMF|Парма|Парма|
PMH|Портсмут|Портсмут|
PMK|Палм Айленд|Пам-Айленд|
PMM|Пханом-Саракхам|Пханом-Саракхам|
PMN|Пумани|Пумани|
PMO|Палермо|Палермо|
PMP|Пимага|Пимага|
PMQ|Перито-Морено|Перито-Морено|
PMR|Палмерстон Норт|Палмерстон Норт|
PMS|Пальмира|Пальмира|
PMZ|Палмар|Палмар|
PNA|Памплона|Памплона|
PND|Пунта-Горда|Пунта-Горда|
PNE|Филадельфия|Филадельфия|
PNH|Пном Пен|Пном Пен|
PNI|Понпеи|Понпеи|
PNK|Понтианак|Понтианак|
PNP|Попондетта|Попондетта|
PNQ|Пуне|Пуне|
PNR|Пуэнт-Нуар|Пуэнт-Нуар|
PNT|Пуэрто Наталес|Пуэрто Наталес|
PNY|Пондичерри|Пондичерри|
POA|Порто Алегре|Порто Алегре|
POD|Подор|Подор|
POG|Порт-Гентил|Порт-Гентил|
POI|Потоси|Потоси|
POM|Порт-Морсби|Порт-Морсби|
PON|Поптун|Поптун|
POP|Ла-Унион|Пуэрто Плата|
POR|Пори|Пори|
POT|Порт-Антонио|Порт-Антонио|
POW|Порторож|Порторос|
POX|Париж|Париж|
POZ|Познан|Познан|
PPE|Пуэрто-Пенаско|Пуэрто-Пенаско|
PPK|Петропавловск|Петропавловск|
PPL|Пхалпу|Пхалпу|
PPN|Попайан|Попайан|
PPO|Пауэлл-Пойнт|Пауэлл-Пойнт|
PPQ|Парапарауму|Парапарауму|
PPR|Пасир-Пангараян|Пасир-Пангараян|
PPU|Папун|Папун|
PPW|Папа-Вестрей|Папа-Вестрей|
PPZ|Пуэрто-Пец|Пуэрто-Пец|
PQC|Пху-Квок|Пху-Квок|
PQM|Паленк|Паленке|
PQQ|Порт Макгуайр|Порт Макгуайр|
PRE|Поре|Поре|
PRG|Прага|Прага|
PRH|Пхраэ|Пхраэ|
PRI|Праслин-Айленд|Праслин-Айленд|
PRJ|Капри|Капри|
PRM|Портиман|Портиман|
PRP|Проприано|Проприано|
PRR|Парума|Парума|
PRS|Параси|Параси|
PRU|Проме|Проме|
PRV|Пршеров|Пршеров|
PRX|Париж|Париж|
PRY|Претория|Претория|
PSA|Пиза|Пиза|
PSD|Порт-Саид|Порт-Саид|
PSI|Пасни|Пасни|
PSJ|Посо|Посо|
PSK|Дублин|Дублин|
PSL|Перт|Перт|
PSO|Пасто|Пасто|
PSP|Палм Спрингс|Палм Спрингс|
PSQ|Филадельфия|Филадельфия|
PSR|Пескара|Пескара|
PSS|Посадас|Посадас|
PST|Престон|Престон|
PSW|Пассос|Пассос|
PSX|Палачос|Палачос|
PTB|Петерсбург|Петерсбург|
PTE|Порт Стефенс|Порт Стефенс|
PTF|Малололайлай|Малололайлай|
PTI|Порт Дуглас|Порт Дуглас|
PTJ|Портланд|Портланд|
PTL|Порт Армстронг|Порт Армстронг|
PTM|Палмарито|Палмарито|
PTX|Питалито|Питалито|
PTY|Панама Сити|Панама Сити|
PTZ|Пастаца|Пастаца|
PUA|Пуас|Пуас|
PUD|Пуэрто-Десеадо|Пуэрто-Десеадо|
PUE|Пуэрто-Обалдиа|Пуэрто-Обалдиа|
PUF|По|По|
PUG|Порт Огаста|Порт Огаста|
PUH|Пошутла|Пошутла|
PUN|Пуниа|Пуниа|
PUP|По|По|
PUQ|Пунта Аренас|Пунта Аренас|
PUR|Пуэрто Рико|Пуэрто Рико|
PUT|Путтапартхи|Путтапартхи|
PUU|Пуэрто-Асис|Пуэрто-Асис|
PUX|Пуэрто Варас|Пуэрто Варас|
PUY|Пула|Пула|
PUZ|Пуэрто-Кабесас|Пуэрто-Кабесас|
PVA|Провиденсиа|Провиденсиа|
PVD|Провиденс|Провиденс|
PVE|Эль-Порвенир|Эль-Порвенир|
PVG|Шанхай|Шанхай|
PVK|Превеза-Лефка|Превеза-Лефка|
PVN|Плевен|Плевен|
PVO|Портовьехо|Портовьехо|
PVR|Пуэрто Ваярта|Пуэрто Ваярта|
PVS|Бухта Проведения|Бухта Провидения|
PVX|Проведения|Бухта Провидения|
PWA|Оклахома Сити|Оклахома Сити|
PWE|Певек|Певек|
PWK|Чикаго|Чикаго|
PWM|Портланд|Портланд|
PWN|Питтс-Таун|Питтс-Таун|
PWO|Пуэто|Пуэто|
PWQ|Павлодар|Павлодар|
PXM|Пуэрто Эскондидо|Пуэрто Эскондидо|
PXO|Порто Санто|Порто Санто|
PXR|Сурин|Сурин|
PXU|Плейку|Плейку|
PYA|Пуэрто-Бояка|Пуэрто-Бояка|
PYB|Джейпор|Джейпор|
PYC|Плейкон-Чико|Плейкон-Чико|
PYE|Пенрин-Айленд|Пенрин-Айленд|
PYH|Пуэрто-Аякучо|Пуэрто-Аякучо|
PYJ|Полярный|Полярный|
PYN|Пайан|Пайан|
PYO|Путумайо|Путумайо|
PYR|Пиргос|Пиргос|
PYV|Явиза|Явиза|
PYX|Паттая|Паттайя|
PZB|Питермарицбург|Питермарицбург|
PZH|Зхоб|Зхоб|
PZO|Пуэрто Ордас|Пуэрто Ордас|
PZU|Порт-Судан|Порт-Судан|
PZY|Пьестаны|Пиестани|
QDU|Дюссельдорф|Дюссельдорф|
QFQ|Мелой|Мелой|
QGV|Франкфурт-на-Майне|Франкфурт-на-Майне|
QLX|Лаутерах|Лаутерах|
QMM|Марина Ди Масса|Марина Ди Масса|
QNY|Нью-Йорк|Нью-Йорк|
QPG|Сингапур|Сингапур|
QQW|Лондон|Лондон|
QRA|Йоханнесбург|Йоханнесбург|
QRO|Керетаро|Керетаро|
QSG|Сондерборг|Сондерборг|
QUF|Таллинн|Таллинн|
QWG|Шарлотт|Шарлотт|
QYW|Канны|Канны|
RAA|Раканда|Раканда|
RAB|Рабаул|Рабаул|
RAC|Рацине|Рацине|
RAE|Арар|Арар|
RAH|Рафха|Рафха|
RAJ|Раджкот|Раджкот|
RAK|Марракеш|Марракеш|
RAN|Равенна|Равенна|
RAP|Рапид Сити|Рапид Сити|
RAQ|Раха|Раха|
RAS|Рашт|Рашт|
RAT|Радужный|Радужный|
RAU|Рангпур|Рангпур|
RAV|Краво-Норте|Краво-Норте|
RAW|Арава|Арава|
RAX|Орам|Орам|
RAY|Ротсей|Ротсей|
RAZ|Равала-Кот|Равала-Кот|
RBA|Сейл|Рабат|
RBB|Борба|Борба|
RBD|Даллас|Даллас|
RBG|Розбург|Розбург|
RBI|Раби|Раби|
RBJ|Ребун|Ребун|
RBK|Ранчо|Ранчо|
RBO|Роборе|Роборе|
RBP|Рабараба|Рабараба|
RBQ|Рурренабак|Рурренабак|
RBT|Марсабит|Марсабит|
RBV|Рамата|Рамата|
RCA|Рапид Сити|Рапид Сити|
RCB|Ричардс-Бей|Ричардс-Бей|
RCH|Риохача|Риохача|
RCL|Редклифф|Редклифф|
RCM|Ричмонд|Ричмонд|
RCO|Рошфор|Рошфор|
RCQ|Реконкиста|Реконкиста|
RCR|Рочестер|Рочестер|
RCS|Рочестер|Рочестер|
RCY|Рум-Кэй|Рум-Кэй|
RDC|Реденкао|Реденкао|
RDE|Мердей|Мердей|
RDR|Ред Ривер (Красная река)|Ред Ривер (Красная река)|
RDT|Ричард-Толл|Ричард-Толл|
RDZ|Родез|Родез|
REC|Ресифе|Ресифе|
REG|Редджио-Калабрия|Редджио-Калабрия|
REH|Рехобот Бич|Рехобот Бич|
REI|Регина|Регина|
REL|Трелью|Трелью|
REN|Оренбург|Оренбург|
REO|Рим|Рим|
REP|Сием Рип|Сием Рип|
RES|Ресистенсия|Ресистенсия|
REU|Реус|Реус|
REW|Рева|Рева|
REY|Рейес|Рейес|
RFA|Рафаи|Рафаи|
RFD|Рокфорд|Рокфорд|
RFN|Рауфархофн|Рауфархофн|
RFR|Рио-Фрио|Рио-Фрио|
RGA|Рио-Гранде|Рио-Гранде|
RGE|Поргера|Поргера|
RGH|Балургат|Балургат|
RGL|Рио-Гальегос|Рио-Гальегос|
RGN|Яньгунь|Яньгунь|
RGT|Ренгат|Ренгат|
RHA|Рейкхолар|Рейкхолар|
RHD|Рио Хондо|Рио Хондо|
RHE|Реймс|Реймс|
RHG|Руэнгери|Руэнгери|
RHL|Рой-Хилл|Рой-Хилл|
RHN|Рош-Пина|Рош Пина|
RHO|Родос|Родос|
RHP|Рамечхап|Рамечхап|
RHV|Сан-Хосе|Сан-Хосе|
RIB|Риберальта|Риберальта|
RIG|Рио-Гранде|Рио-Гранде|
RIJ|Риоха|Риоха|
RIK|Карилло|Каррилльо|
RIN|Ринги-Коув|Ринги-Коув|
RIS|Рисири|Рисири|
RIT|Рио-Тигре|Рио-Тигре|
RIX|Рига|Рига|
RIZ|Рио-Альцукар|Рио-Альцукар|
RJA|Раджахмандри|Раджахмандри|
RJB|Раджбирадж|Раджбирадж|
RJI|Раджури|Раджури|
RJK|Риека|Риека|
RJL|Логроно|Логроно|
RKC|Ирека|Ирека|
RKE|Копенгаген|Копенгаген|
RKI|Рокот|Рокот|
RKO|Сипора|Сипора|
RKS|Рок Спрингс|Рок Спрингс|
RKT|Рас-аль-Хайма|Рас-аль-Хайма|
RKU|Юл-Айленд|Юл-Айленд|
RKV|Кефлавик|Рейкьявик|
RLT|Арлит|Арлит|
RMB|Бурайми|Бурайми|
RMC|Рокфорд|Рокфорд|
RMD|Рамагундам|Рамагундам|
RMG|Рим|Рим|
RMI|Мирамаре|Римини|
RMN|Румгиней|Румгиней|
RMQ|Тайчунг|Тайчунг|
RMS|Рамштайн|Рамштайн|
RNA|Арона|Арона|
RNB|Роннеби|Роннеби|
RND|Сен Антонио|Сен Антонио|
RNE|Руан|Руан|
RNI|Корн-Айленд|Корн-Айленд|
RNR|Робинзон-Ривер|Робинзон-Ривер|
RNS|Ренн|Ренн|
RNU|Ранау|Ранау|
ROI|Рой Ет|Рой Ет|
ROK|Рокхэмптон|Рокхэмптон|
RON|Рондон|Рондон|
ROP|Рота|Рота|
ROS|Росарио|Росарио|
ROT|Роторуа|Роторуа|
ROV|Ростов|Ростов|
ROY|Рио-Майо|Рио-Майо|
RPA|Ролпа|Ролпа|
RPB|Ропер-Бэй|Ропер-Бэй|
RPN|Рош-Пина|Рош Пина|
RPR|Райпур|Райпур|
RRA|Ронда|Ронда|
RRI|Барора|Барора|
RRK|Руркела|Руркела|
RRM|Марромеу|Марромеу|
RRO|Соренто|Неаполь|
RRS|Ророс|Ророс|
RRV|Робинзон-Ривер|Робинзон-Ривер|
RSA|Санта-Роза|Санта-Роса|
RSE|Сидней|Сидней|
RSG|Серра-Пелада|Серра-Пелада|
RSI|Рио-Сидра|Рио-Сидра|
RSJ|Росарио|Росарио|
RSK|Рансики|Рансики|
RSL|Расселл|Расселл|
RSS|Росейрес|Росейрес|
RST|Рочестер|Рочестер|
RSW|Форт Майерс|Форт Майерс|
RTB|Роатан|Роатан|
RTC|Ратнагири|Ратнагири|
RTG|Рутенг|Рутенг|
RTI|Роти|Роти|
RTM|Роттердам|Роттердам|
RTP|Рутланд-Плейнз|Рутланд-Плейнз|
RTS|остров Роттнест|остров Роттнест|
RTW|Саратов|Саратов|
RUA|Аруа|Аруа|
RUG|Руган|Руган|
RUH|Халлсберг|Халлсберг|
RUK|Рукумкот|Рукумкот|
RUP|Рупси|Рупси|
RUT|Рутленд|Рутленд|
RUV|Рубелсанто|Рубелсанто|
RUY|Копан|Копан|
RVA|Фарафангана|Фарафангана|
RVD|Риу-Верди|Риу-Верди|
RVE|Саравена|Саравена|
RVH|Ржевка|Санкт-Петербург|
RVN|Рованиеми|Рованиеми|
RVO|Рейвило|Рейвило|
RVR|Грин-Ривер|Грин-Ривер|
RVS|Тулса|Тулса|
RVY|Ривера|Ривера|
RWN|Ровно|Ровно|
RXA|Рауда|Рауда|
RXS|Розас-Сити|Рохас Сити|
RYB|Рыбинск|Рыбинск|
RYK|Рахим-Яр-Хан|Рахим-Яр-Хан|
RYN|Ройан|Ройан|
RYO|Рио-Турбио|Рио-Турбио|
RZA|Санта-Круз|Санта-Круз-Айленд|
RZE|Жешув|Жешув|
RZN|Турлатово|Рязань|
RZR|Рамсар|Рамсар|
SAC|Сакраменто|Сакраменто|
SAE|Сангир|Сангир|
SAF|Санта Фе|Санта Фе|
SAJ|Сираджгандж|Сираджгандж|
SAK|Саударкрокур|Саударкрокур|
SAL|Сан-Сальвадор|Сан-Сальвадор|
SAM|Саламо|Саламо|
SAN|Сан Диего|Сан Диего|
SAR|Спарта|Спарта|
SAT|Сен Антонио|Сен Антонио|
SAU|Саву|Саву|
SAV|Саванна|Саванна|
SAW|Стамбул|Стамбул|
SAX|Самбу|Самбу|
SAY|Сиена|Сиенна|
SAZ|Сасстаун|Сасстаун|
SBA|Санта-Барбара-Ба|Санта-Барбара-Ба|
SBD|Сан Бернардино|Сан Бернардино|
SBF|Сардех-Банд|Сардех-Банд|
SBI|Кундара|Кундара|
SBL|Санта-Ана|Санта-Ана|
SBP|Сан Луис Обиспо|Сан Луис Обиспо|
SBQ|Сиби|Сиби|
SBT|Сан Бернардино|Сан Бернардино|
SBU|Спрингбок|Спрингбок|
SBV|Сабах|Сабах|
SBZ|Сибиу|Сибиу|
SCA|Санта-Каталина|Санта-Каталина|
SCD|Зулако|Зулако|
SCF|Феникс|Феникс|
SCI|Сан-Кристобаль|Сан-Кристобаль|
SCL|Сантьяго|Сантьяго|
SCO|Актау|Актау|
SCQ|Сантьяго де Компостела|Сантьяго де Компостела|
SCT|Сокотра|Сокотра|
SCU|Сантьяго|Сантьяго|
SCV|Сучава|Сучава|
SCW|Сыктывкар|Сыктывкар|
SCX|Залина-Крус|Залина-Крус|
SCY|Сан-Кристобаль|Сан-Кристобаль|
SDA|Багдад|Багдад|
SDC|Сендкрик|Сендкрик|
SDG|Санандадж|Санандадж|
SDI|Сайдор|Сайдор|
SDJ|Сендай|Сендай|
SDK|Сандакан|Сандакан|
SDL|Сандсвалль|Сандсвалль|
SDM|Сан Диего|Сан Диего|
SDQ|Санто-Доминго|Санто-Доминго|
SDR|Сантандер|Сантандер|
SDS|Садо-Сима|Садо-Сима|
SDT|Саиду-Шариф|Саиду-Шариф|
SDW|Сандвип|Сандвип|
SDX|Седона|Седона|
SEB|Себа|Себа|
SEC|Серр Шевалье|Сер-Шевалье|
SEE|Сан Диего|Сан Диего|
SEH|Сенггех|Сенггех|
SEK|Ксар-Эс-Сук|Ксар-Эс-Сук|
SET|Сан-Эстебан|Сан-Эстебан|
SEU|Серонера|Серонера|
SEV|Северодонецк|Северодонецк|
SEW|Сива|Сива|
SEX|Зембах|Зембах|
SEY|Селибаби|Селибаби|
SEZ|Остров Махе|Остров Махе|
SFA|Сфакс|Сфакс|
SFE|Сан Фернандо|Сан Фернандо|
SFF|Спокане|Спокане|
SFH|Сан-Фелипе|Сан-Фелипе|
SFI|Сафи|Сафи|
SFN|Санта Фе|Санта Фе|
SFR|Сан Фернандо|Сан Фернандо|
SFT|Скеллефти|Скеллефти|
SFU|Сафиа|Сафиа|
SFW|Санта Фе|Санта Фе|
SFX|Сан-Феликс|Сан-Феликс|
SGB|Сингауа|Сингауа|
SGC|Сургут|Сургут|
SGD|Сондерборг|Сондерборг|
SGE|Зиген|Зиген|
SGG|Симанганг|Симанганг|
SGI|Саргодха|Саргодха|
SGJ|Сагарай|Сагарай|
SGK|Сангапи|Сангапи|
SGM|Сан-Игнасио|Сан-Игнасио|
SGN|Хо Чи Мин Сити|Хо Чи Мин Сити|
SGO|Сент Джордж|Сент Джордж|
SGQ|Санггата|Санггата|
SGS|Санга-Санга|Санга-Санга|
SGV|Сьерра-Гранде|Сьерра-Гранде|
SGX|Сонгеа|Сонгеа|
SGZ|Сонгкхла|Сонгкхла|
SHA|Шанхай|Шанхай|
SHB|Накасибецу|Накасибецу|
SHC|Индаселасси|Индаселасси|
SHE|Шеньян|Шеньян|
SHF|Шаньягван|Шаньягван|
SHI|Симожисима|Симожисима|
SHJ|Шарджа|Шарджа|
SHK|Сехонгхонг|Сехонгхонг|
SHL|Шиллонг|Шиллонг|
SHM|Ширахама|Ширахама|
SHO|Сокчо|Сокчо|
SHP|Циньхуандао|Циньхуандао|
SHS|Шаши|Шаши|
SHT|Шеппартон|Шеппартон|
SHV|Шревспорт|Шревспорт|
SHW|Шарура|Шарура|
SHY|Шиньянга|Шиньянга|
SHZ|Сешутес|Сешутес|
SIB|Сибити|Сибити|
SIC|Синоп|Синоп|
SIE|Синес|Синес|
SIF|Симара|Симара|
SIG|Сан Хуан|Сан Хуан|
SIH|Силгади-Доти|Силгади-Доти|
SII|Сиди-Ифни|Сиди-Ифни|
SIJ|Сиглуфьордур|Сиглуфьордур|
SIL|Сила|Сила|
SIM|Симбай|Симбай|
SIN|Сингапур|Сингапур|
SIP|Симферополь|Симферополь|
SIR|Сион|Сион|
SIS|Сишен|Сишен|
SIU|Сиуна|Сиуна|
SIW|Сибиса|Сибиса|
SIZ|Сиссано|Сиссано|
SJA|Сан Хуан|Сан Хуан|
SJB|Сан-Хоакин|Сан-Хоакин|
SJC|Сан-Хосе|Сан-Хосе|
SJG|Сан-Педро-Жапуа|Сан-Педро-Жапуа|
SJI|Сан-Хосе|Сан-Хосе|
SJJ|Сараево|Сараево|
SJL|Сан-Габриэл|Сан-Габриэл|
SJM|Сан Хуан|Сан Хуан|
SJN|Сент Джонс|Сент Джонс|
SJP|Сан Хосе Ду Рио Прето|Сан Хосе Ду Рио Прето|
SJQ|Сешеке|Сешеке|
SJS|Сан Хосе|Сан-Хосе|
SJU|Сан Хуан|Сан Хуан|
SJV|Сан-Хавьер|Сан-Хавьер|
SJW|Шицзяжун|Шицзяжун|
SJX|Сартанеджа|Сартанеджа|
SJY|Сейнайоки|Сейнайоки|
SKA|Спокане|Спокане|
SKC|Суки|Суки|
SKD|Самарканд|Самарканд|
SKE|Скиен|Скиен|
SKF|Сен Антонио|Сен Антонио|
SKG|Салоники|Салоники|
SKI|Скикда|Скикда|
SKM|Скелдон|Скелдон|
SKN|Скаген|Скаген|
SKO|Сокото|Сокото|
SKP|Скопье|Скопье|
SKQ|Секакес|Секакес|
SKR|Шакисо|Шакисо|
SKT|Сиалкот|Сиалкот|
SKU|Скирос|Скирос|
SKV|Санта-Катарина|Санта-Катарина|
SKX|Саранск|Саранск|
SKY|Сандуски|Сандуски|
SKZ|Суккур|Суккур|
SLA|Сальта|Сальта|
SLB|Сторм Лейк|Сторм Лейк|
SLD|Шлияк|Шлияк|
SLF|Сулаель|Сулаель|
SLH|Сола|Сола|
SLI|Солвези|Солвези|
SLJ|Чандлер|Чандлер|
SLL|Салала|Салала|
SLM|Саламанка|Саламанка|
SLP|Сан-Луис-Потоси|Сан-Луис-Потоси|
SLS|Силистра|Силистра|
SLV|Симла|Симла|
SLW|Сальтильо|Сальтильо|
SLY|Салехард|Салехард|
SMA|Санта-Мария|Санта-Мария|
SMB|Сьерро-Сомбреро|Сьерро-Сомбреро|
SMC|Санта Мария|Санта-Мария|
SMG|Санта Мария|Санта-Мария|
SMH|Сапманга|Сапманга|
SMJ|Сим|Сим|
SMO|Санта Моника|Санта Моника|
SMP|Стокгольм|Стокгольм|
SMR|Санта Марта|Санта Марта|
SMT|Сан-Мун-Лейк|Сан-Мун-Лейк|
SMV|Сент Мориц|Сент Мориц|
SMW|Смара|Смара|
SMX|Санта-Мария|Санта-Мария|
SMY|Сименти|Сименти|
SND|Сено|Сено|
SNF|Сан-Фелипе|Сан-Фелипе|
SNI|Синоу|Синоу|
SNJ|Сан-Хулиан|Сан-Хулиан|
SNN|Шеннон|Шеннон|
SNO|Сакан Накхон|Сакан Накхон|
SNQ|Сан-Кинтин|Сан-Кинтин|
SNU|Санта-Клара|Санта-Клара|
SNV|Санта-Элена|Санта-Элена|
SNZ|Санта-Круз|Санта-Круз-Айленд|
SOA|Сок-Транг|Сок-Транг|
SOC|Соло Сити|Соло Сити|
SOD|Сорокаба|Сорокаба|
SOE|Суанке|Суанке|
SOF|София|София|
SOG|Сондал|Сондал|
SOH|Солита|Солита|
SOI|Остров Саут Молл|Остров Саут Молл|
SOJ|Соркьосен|Соркьосен|
SOK|Семонгконг|Семонгконг|
SOM|Сан-Томе|Сан-Томе|
SOO|Содерхамн|Содерхамн|
SOR|Эль-Таура|Эль-Таура|
SOT|Соданкюля|Соданкюля|
SOX|Согамосо|Согамосо|
SOY|Стронсей|Стронсей|
SPC|Ля Пальма|Ля Пальма|
SPE|Сепулот|Сепулот|
SPH|Сопу|Сопу|
SPJ|Афины|Афины|
SPO|Сан-Пабло|Сан-Пабло|
SPP|Менонге|Менонге|
SPQ|Сан-Педро|Сан-Педро|
SPR|Сан-Педро|Сан-Педро|
SPT|Сипитанг|Сипитанг|
SPU|Сплит|Сплит|
SPX|Хьюстон|Хьюстон|
SPY|Сан-Педро|Сан-Педро|
SQB|Санта-Ана|Санта-Ана|
SQD|Синоп|Синоп|
SQF|Солано|Солано|
SQJ|Шехди|Шехди|
SQL|Сан Карлос|Сан Карлос|
SQN|Санана|Санана|
SQO|Сторуман|Сторуман|
SQR|Сороако|Сороако|
SQS|Сан-Игнасио|Сан-Игнасио|
SQU|Субик-Бей|Субик-Бей|
SRA|Санта-Роза|Санта-Роса|
SRB|Санта-Роза|Санта-Роса|
SRD|Сан-Рамон|Сан-Рамон|
SRE|Сукре|Сукре|
SRF|Сан-Рафаэль|Сан-Рафаэль|
SRG|Семаранг|Семаранг|
SRH|Сарх|Сарх|
SRI|Самаринда|Самаринда|
SRJ|Сан-Борха|Сан-Борха|
SRK|Сьерра-Леоне|Сьерра-Леоне|
SRL|Санта-Розалиа|Санта-Росалия|
SRN|Страхан|Страхан|
SRO|Сантана-Рамос|Сантана-Рамос|
SRP|Сторд|Сторд|
SRS|Сан-Маркос|Сан-Маркос|
SRT|Сороти|Сороти|
SRU|Санта-Круз-Айленд|Санта-Круз-Айленд|
SRX|Серт|Серт|
SRY|Сари|Сари|
SRZ|Санта-Круз-Айленд|Санта-Круз-Айленд|
SSD|Сан-Фелипе|Сан-Фелипе|
SSE|Шолапур|Шолапур|
SSF|Сен Антонио|Сен Антонио|
SSG|Санта-Исабел-ду-М|Малабо|
SSH|Шарм Эль Шейх|Шарм Эль Шейх|
SSJ|Санднессьоен|Санднессьоен|
SSL|Санта-Розалиа|Санта-Росалия|
SSO|Сан-Лоуренсу|Сан-Лоуренсу|
SSR|Сара|Сара|
SSS|Сиасси|Сиасси|
SST|Санта-Тересита|Санта-Тересита|
SSX|Самсун|Самсун|
STD|Санто-Доминго|Санто-Доминго|
STI|Сантьяго|Сантьяго|
STL|Сент Луис|Сент Луис|
STM|Сантарем|Сантарем|
STN|Лондон|Лондон|
STP|Сен Поль|Сен Поль|
STR|Штуттгард|Штуттгард|
STS|Санта-Роса|Санта-Роса|
STU|Санта-Круз|Санта-Круз-Айленд|
STV|Сурат|Сурат|
STW|Ставрополь|Ставрополь|
STZ|Санта-Терезинья|Санта-Терезинья|
SUB|Сурабайя|Сурабайя|
SUG|Суригао|Суригао|
SUH|Сур|Сур|
SUI|Сухуми|Сухуми|
SUJ|Сату Маре|Сату Маре|
SUL|Суи|Суи|
SUO|Сан-Ривер, шт. Орегон|Сан-Ривер, шт. Орегон|
SUP|Суменеп|Суменеп|
SUQ|Сукуа|Сукуа|
SUR|Саммер-Бивер|Саммер-Бивер|
SUS|Сент Луис|Сент Луис|
SUT|Сумбаванга|Сумбаванга|
SUV|Сува|Сува|
SUX|Сиокс Сити|Сиокс Сити|
SUY|Судурейри|Судурейри|
SUZ|Суриа|Суриа|
SVB|Самбава|Самбава|
SVF|Саве|Саве|
SVG|Сола|Ставангер|
SVJ|Сволваер|Сволваер|
SVK|Силвер-Крик|Силвер-Крик|
SVL|Савонлинна|Савонлинна|
SVO|Шереметьево|Москва|
SVP|Куито|Куито|
SVQ|Сан-Пабло|Сан-Пабло|
SVR|Свей-Рьенг|Свей-Рьенг|
SVU|Савусаву|Савусаву|
SVX|Кольцово|Екатеринбург|
SVY|Саво|Саво|
SVZ|Сан-Антонио|Сен Антонио|
SWA|Шаньтоу|Шаньтоу|
SWE|Сивеа|Сивеа|
SWH|Суон Хилл|Суон Хилл|
SWI|Свиндон|Свиндон|
SWJ|Сауз-Вест-Бей|Сауз-Вест-Бей|
SWK|Милан|Милан|
SWL|Спаниш-Уэллс|Спаниш-Уэллс|
SWN|Сахивал|Сахивал|
SWP|Свакопмунд|Свакопмунд|
SWS|Суони|Суони|
SWT|Стрежевой|Стрежевой|
SWU|Суон|Суон|
SWY|Ситиаван|Ситиаван|
SWZ|Сидней|Сидней|
SXA|Сиалум|Сиалум|
SXB|Страсбург|Страсбург|
SXD|София Антиполис|София Антиполис|
SXE|Сейл|Сейл|
SXF|Берлин|Берлин|
SXG|Сенанга|Сенанга|
SXH|Сехулеа|Сехулеа|
SXI|Сирри-Айленд|Сирри-Айленд|
SXJ|Шаньшань|Шаньшань|
SXK|Саумлаки|Саумлаки|
SXL|Слайго|Слайго|
SXR|Сринагар|Сринагар|
SXS|Сахабат-16|Сахабат-16|
SXT|Таман Негара|Таман Негара|
SXU|Содду|Содду|
SXZ|Сиирт|Сиирт|
SYD|Сидней|Сидней|
SYE|Сада|Сада|
SYK|Стиккишолмур|Стиккишолмур|
SYL|Сан-Мигель|Сан-Мигель|
SYM|Симан|Симан|
SYO|Сонай|Сонай|
SYP|Сантьяго|Сантьяго|
SYR|Сиракус|Сиракус|
SYX|Санья|Санья|
SYZ|Шираз|Шираз|
SZA|Сойо|Сойо|
SZB|Куала-Лумпур|Куала-Лумпур|
SZC|Гуанакасте|Санта-Круз-Айленд|
SZD|Шеффилд|Шеффилд|
SZE|Семера|Семера|
SZF|Самсун|Самсун|
SZG|Зальцбург|Зальцбург|
SZH|Сенипах|Сенипах|
SZI|Зайсан|Зайсан|
SZK|Скукуза|Скукуза|
SZL|Варренсбург|Варренсбург|
SZM|Сезрим|Сезрим|
SZN|Санта-Барбара-Ба|Санта-Барбара-Ба|
SZQ|Саенц-Пена|Саенц-Пена|
SZR|Стара-Загора|Стара-Загора|
SZS|Стюарт-Айленд|Стюарт-Айленд|
SZU|Сегу|Сегу|
SZV|Сучжоу|Сучжоу|
SZW|Шверин|Шверин|
SZX|Шэньчжэнь|Шэньчжэнь|
SZZ|Щецин|Щецин|
TAA|Тарапайна|Тарапайна|
TAD|Тринидад|Тринидад|
TAE|Даегу|Даегу|
TAF|Оран|Оран|
TAG|Тагбиларан|Тагбиларан|
TAJ|Таджи|Айтейп|
TAK|Такаматсу|Такаматсу|
TAL|Танана|Танана|
TAM|Тампико|Тампико|
TAN|Тангалума|Тангалума|
TAO|Куаньдян|Куаньдян|
TAP|Тапашула|Тапашула|
TAQ|Таркула|Таркула|
TAR|Таранто|Таранто|
TAS|Южный|Ташкент|
TAT|Попрад|Попрад|
TAU|Таурамена|Таурамена|
TAW|Такуарембо|Такуарембо|
TAX|Талиабу|Талиабу|
TAY|Тарту|Тарту|
TBA|Табибуга|Табибуга|
TBB|Туй-Хоа|Туй-Хоа|
TBD|Тимбуки|Тимбуки|
TBE|Тимбунке|Тимбунке|
TBF|Табитуа-Норт|Табитуа-Норт|
TBG|Табубил|Табубил|
TBH|Таблас|Таблас|
TBI|Зе-Байт|Зе-Байт|
TBJ|Табарка|Табарка|
TBK|Тимбер-Крик|Тимбер-Крик|
TBL|Тейблленд|Тейблленд|
TBM|Тумбанг-Самба|Тумбанг-Самба|
TBO|Табора|Табора|
TBP|Тумбес|Тумбес|
TBQ|Тарабо|Тарабо|
TBS|Тбилиси|Тбилиси|
TBW|Тамбов|Тамбов|
TBZ|Табриз|Табриз|
TCA|Теннант Крик|Теннант Крик|
TCC|Тукумкари|Тукумкари|
TCD|Тарапака|Тарапака|
TCE|Тулча|Тулча|
TCF|Токоа|Токоа|
TCH|Чибанга|Чибанга|
TCN|Теуакан|Теуакан|
TCO|Тумако|Тумако|
TCP|Таба|Таба|
TCV|Тете|Тете|
TDA|Тринидад|Тринидад|
TDD|Тринидад|Тринидад|
TDG|Тандаг|Тандаг|
TDJ|Таджура|Таджура|
TDK|Талды-Курган|Талды-Курган|
TDL|Тандиль|Тандиль|
TDO|Толедо|Толедо|
TDR|Теодоре|Теодоре|
TDT|Танда Тула|Танда Тула|
TDV|Танандава|Танандава|
TDW|Трейдвинд|Амарильо|
TDX|Трат|Трат|
TDZ|Толедо|Толедо|
TEA|Тела|Тела|
TED|Тистед|Тистед|
TEE|Тбесса|Тбесса|
TEG|Тенкодого|Тенкодого|
TEI|Тезу|Тезу|
TEL|Телупид|Телупид|
TEO|Терапо|Терапо|
TEP|Тептеп|Тептеп|
TEQ|Текиргад|Текиргад|
TES|Тессеней|Тессеней|
TET|Тете|Тете|
TEU|Те Анау|Те Анау|
TEY|Тингейри|Тингейри|
TEZ|Тезпур|Тезпур|
TFC|Таормина|Таормина|
TFF|Тефе|Тефе|
TFI|Туфи|Туфи|
TFM|Телефомин|Телефомин|
TFN|Тенерифе|Тенерифе|
TFR|Рамадан|Рамадан|
TFS|Тенерифе|Тенерифе|
TFT|Тафтан|Тафтан|
TFY|Тарфая|Тарфая|
TGF|Тинье|Тинье|
TGG|Куала-Теренгану|Куала-Теренгану|
TGH|Тонгоа|Тонгоа|
TGI|Тинго-Мария|Тинго-Мария|
TGJ|Тига|Тига|
TGL|Тагула|Тагула|
TGM|Тиргу Мурес|Тиргу Мурес|
TGO|Тонглян|Тонглян|
TGQ|Тангара де Серра|Тангара де Серра|
TGT|Танга|Танга|
TGU|Тегусигальпа|Тегусигальпа|
TGV|Тарговиште|Тарговиште|
TGZ|Тухтла-Гутьеррес|Тухтла-Гутьеррес|
THC|Тчиен|Тчиен|
THE|Терезина|Терезина|
THF|Берлин|Берлин|
THH|Тахароа|Тахароа|
THI|Тишитт|Тишитт|
THK|Тхакхек|Тхакхек|
THL|Тачилек|Тачилек|
THN|Тролльхеттан|Тролльхеттан|
THO|Торсхофн|Торсхофн|
THP|Термополис|Термополис|
THR|Техран|Техран|
THS|Сукотай|Сукотай|
THT|Тамшакет|Тамшакет|
THZ|Тахуа|Тахуа|
TIB|Тибу|Тибу|
TID|Тиарет|Тиарет|
TIE|Типпи|Типпи|
TIF|Таиф|Таиф|
TIG|Тингвон|Тингвон|
TIH|Тикехау-Атолл|Тикехау-Атолл|
TII|Таринкот|Таринкот|
TIJ|Тихуана|Тихуана|
TIK|Оклахома Сити|Оклахома Сити|
TIM|Тимика|Тимика|
TIN|Тиндуф|Тиндуф|
TIO|Тилин|Тилин|
TIP|Триполи|Триполи|
TIR|Тирупати|Тирупати|
TIU|Тимару|Тимару|
TIV|Тиват|Тиват|
TIW|Такома|Такома|
TIY|Тиджикья|Тиджикья|
TIZ|Тари|Тари|
TJI|Трухилло|Трухилло|
TJK|Токат|Токат|
TJM|Рощино|Тюмень|
TJV|Тханджавур|Тханджавур|
TKB|Текаду|Текаду|
TKC|Тико|Тико|
TKD|Такоради|Такоради|
TKG|Бандар-Лампунг|Бандар-Лампунг|
TKH|Такхли|Такхли|
TKM|Тикал|Тикал|
TKO|Тлокоэнг|Тлокоэнг|
TKP|Такапото|Такапото|
TKQ|Кигома|Кигома|
TKR|Такургаон|Такургаон|
TKS|Токусима|Токушима|
TKT|Так|Так|
TKU|Турку|Турку|
TKV|Татакото|Татакото|
TKW|Текин|Текин|
TKX|Такароа|Такароа|
TLB|Тарбела|Тарбела|
TLE|Тулеар|Тулеар|
TLH|Таллахасси|Таллахасси|
TLI|Толитоли|Толитоли|
TLJ|Таталина|Таталина|
TLK|Талкнафьордур|Талкнафьордур|
TLL|Таллинн|Таллинн|
TLN|Хиерес|Хиерес|
TLO|Тол|Тол|
TLP|Тумболбил|Тумболбил|
TLS|Тулуз|Тулуз|
TLU|Толу|Толу|
TLW|Таласеа|Таласеа|
TLX|Талька|Талька|
TMB|Майами|Майами|
TMC|Тамболака|Тамболака|
TMD|Тимбедра|Тимбедра|
TME|Таме|Таме|
TMG|Томангонг|Томангонг|
TMH|Танахмерах|Танахмерах|
TMJ|Термез|Термез|
TMK|Тамки|Тамки|
TML|Тамале|Тамале|
TMM|Таматаве|Таматаве|
TMO|Тумеремо|Тумеремо|
TMP|Тампере|Тампере|
TMQ|Тамбао|Тамбао|
TMR|Таманрассет|Таманрассет|
TMU|Тамбор|Тамбор|
TMW|Тамворт|Тамворт|
TMX|Тимимун|Тимимун|
TNA|Цзинань|Цзинань|
TNB|Танах-Гродот|Танах-Гродот|
TND|Тринидад|Тринидад|
TNE|Танегасима|Танегасима|
TNG|Танжер|Танжер|
TNH|Тонхва|Тонхва|
TNI|Сатна|Сатна|
TNL|Тернополь|Тернополь|
TNN|Тайнань|Тайнань|
TNO|Тамариндо|Тамариндо|
TNR|Антананариву|Антананариву|
TNT|Майами|Майами|
TNU|Ньютон|Ньютон|
TOA|Торранс|Торранс|
TOB|Тобрук|Тобрук|
TOD|Тиоман|Тиоман|
TOE|Тозер|Тозер|
TOF|Богашево|Томск|
TOH|Торрес|Торрес|
TOJ|Мадрид|Мадрид|
TOK|Торокина|Торокина|
TOM|Томбукту|Томбукту|
TON|Тону|Тону|
TOQ|Токопийа|Токопийа|
TOS|Тромсо|Тромсо|
TOT|Тотнесс|Тотнесс|
TOU|Туо|Туо|
TOW|Толедо|Толедо|
TOX|Тобольск|Тобольск|
TOY|Тояма|Тояма|
TPA|Тампа|Тампа|
TPC|Тарапоа|Тарапоа|
TPG|Тайпинг|Тайпинг|
TPH|Тонопа|Тонопа|
TPI|Тапини|Тапини|
TPJ|Тапледжунг|Тапледжунг|
TPK|Тапактуан|Тапактуан|
TPN|Типутини|Типутини|
TPP|Тарапото|Тарапото|
TPQ|Тепик|Тепик|
TPS|Тапини|Тапини|
TPT|Тапета|Тапета|
TPU|Тикапур|Тикапур|
TQN|Талукан|Талукан|
TQS|Трес-Эскинас|Трес-Эскинас|
TRA|Тарамажима|Тарамажима|
TRB|Турбо|Турбо|
TRC|Торреон|Торреон|
TRD|Трондхайм|Трондхайм|
TRF|Сандефьорд|Сандефьорд|
TRG|Тауранга|Тауранга|
TRJ|Таракбиц|Таракбиц|
TRN|Турин|Турин|
TRO|Тари|Тари|
TRR|Тринкомали|Тринкомали|
TRS|Триест|Триест|
TRU|Трухийо|Трухилло|
TRV|Тривандрум|Тривандрум|
TRW|Тарава|Тарава|
TRY|Тороро|Тороро|
TRZ|Тиручирапалли|Тиручирапалли|
TSB|Тсумеб|Тсумеб|
TSC|Таиша|Таиша|
TSD|Тшиписе|Тшиписе|
TSE|Астана|Астана|
TSF|Тревисо|Тревисо|
TSG|Танакросс|Танакросс|
TSH|Тшикапа|Тшикапа|
TSI|Цили-Цили|Цили-Цили|
TSJ|Цусима|Цусима|
TSK|Таскул|Таскул|
TSL|Тамуин|Тамуин|
TSM|Таос|Таос|
TSN|Тяньцзинь|Тяньцзинь|
TSQ|Торрес|Торрес|
TSR|Тимисоара|Тимисоара|
TSS|Нью-Йорк|Нью-Йорк|
TST|Транг|Транг|
TSU|Табитуа-Сауз|Табитуа-Сауз|
TSV|Таунсвилл|Таунсвилл|
TSW|Цеви|Цеви|
TSY|Тасикмалая|Тасикмалая|
TTA|Тан Тан|Тан Тан|
TTB|Арбатакс|Арбатакс|
TTC|Талтал|Талтал|
TTE|Тернате|Тернате|
TTG|Тартагал|Тартагал|
TTH|Тумрайт|Тумрайт|
TTJ|Тоттори|Тоттори|
TTL|Тертл-Айленд|Тертл-Айленд|
TTQ|Тортукеро|Тортукеро|
TTR|Тана Торайа|Тана Торайа|
TTS|Тсаратанана|Тсаратанана|
TTT|Тайтунг|Тайтунг|
TUC|Тукуман|Тукуман|
TUD|Тамбакунда|Тамбакунда|
TUE|Тупиле|Тупиле|
TUF|Турс|Турс|
TUG|Тугуэгарао|Тугуэгарао|
TUI|Тураиф|Тураиф|
TUJ|Тум|Тум|
TUK|Турбат|Турбат|
TUL|Тулса|Тулса|
TUN|Тунис|Тунис|
TUO|Таупо|Таупо|
TUP|Тупело|Тупело|
TUQ|Туган|Туган|
TUT|Таута|Таута|
TUU|Табук|Табук|
TUV|Тукупита|Тукупита|
TUW|Тубала|Тубала|
TUY|Тулум|Тулум|
TUZ|Тукума|Тукума|
TVA|Морафенобе|Морафенобе|
TVC|город Траверсе|город Траверсе|
TVL|Южное Озеро Тахо|Южное Озеро Тахо|
TVU|Тавеуни|Тавеуни|
TWE|Тейлор|Тейлор|
TWZ|Маунт Кук|Маунт Кук|
TXG|Тайчунг|Тайчунг|
TXL|Берлин|Берлин|
TXM|Теминабуан|Теминабуан|
TXN|Тунси|Тунси|
TXR|Танбар|Танбар|
TYA|Тула|Тула|
TYD|Тында|Тында|
TYM|Станиэл-Кэй|Станиэл-Кэй|
TYN|Тайвань|Тайвань|
TYS|Ноксвилл|Ноксвилл|
TYZ|Тейлор|Тейлор|
TZL|Тузла|Тузла|
TZM|Тисимин|Тисимин|
TZX|Трабзон|Трабзон|
UAB|Адана|Адана|
UAC|Сан-Луис-Рио-Колорадо|Сан-Луис-Рио-Колорадо|
UAE|Маунт-Эу|Маунт-Эу|
UAI|Суаи|Суаи|
UAL|Луау|Луау|
UAQ|Сан Хуан|Сан Хуан|
UAS|Самбуру|Самбуру|
UAX|Уахактун|Уахактун|
UBA|Юбераба|Юбераба|
UBI|Буин|Буин|
UBJ|Убе|Убе|
UBP|Убон-Ратчатхани|Убон-Ратчатхани|
UBT|Убатуба|Убатуба|
UCK|Луцк|Луцк|
UCN|Бучанан|Бучанан|
UCT|Ухта|Ухта|
UDA|Ундарра|Ундарра|
UDD|Палм Спрингс|Палм Спрингс|
UDJ|Ужгород|Ужгород|
UDO|Удомхей|Удомхей|
UDR|Удайпур|Удайпур|
UEE|Куинстаун|Куинстаун|
UEL|Келимане|Келимане|
UES|Ваукеша|Ваукеша|
UET|Кветта|Кветта|
UFA|Уфа|Уфа|
UGC|Угренч|Ургенч|
UGO|Уиже|Уиже|
UHE|Угерске-Градиште|Угерске-Градиште|
UIB|Кибдо|Кибдо|
UIK|Усть-Ильимск|Усть-Илимск|
UIN|Куинси|Куинси|
UIO|Куито|Куито|
UIP|Куимпер|Куимпер|
UIQ|Кин-Хилл|Кин-Хилл|
UJE|Удже-Айленд|Удже-Айленд|
UKB|Коб|Кобе|
UKK|Усть-Каменогорск|Усть-Каменогорск|
UKR|Мукейрас|Мукейрас|
UKS|Бельбек|Севастополь|
UKU|Нуку|Нуку|
UKX|Усть-Кут|Усть-Кут|
UKY|Киото|Киото|
ULA|Сан-Хулиан|Сан-Хулиан|
ULB|Улей|Улей|
ULC|Сантьяго|Сантьяго|
ULD|Улунди|Улунди|
ULE|Зуле|Зуле|
ULL|Мулл|Мулл|
ULQ|Тулуа|Тулуа|
ULS|Мулатос|Мулатос|
ULU|Гулу|Гулу|
ULY|Восточный|Ульяновск|
UMC|Умба|Умба|
UMD|Уумманнак|Уумманнак|
UME|Умео|Умео|
UMY|Сумы|Сумы|
UNC|Унгиа|Унгиа|
UND|Кундуз|Кундуз|
UNG|Киунга|Киунга|
UNI|Юнион-Айленд|Юнион-Айленд|
UNN|Ранонг|Ранонг|
UON|Муонг-Сей|Муонг-Сей|
UPA|Пунта-Алегре|Пунта-Алегре|
UPB|Гавана|Гавана|
UPC|Пуэрто Ла Крус|Пуэрто Ла Крус|
UPL|Упала|Упала|
UPN|Уруапан|Уруапан|
UPR|Упиара|Упиара|
URA|Уральск|Уральск|
URC|Урумги|Урумги|
URE|Курессааре|Курессааре|
URI|Урибе|Урибе|
URJ|Урай|Урай|
URM|Уриман|Уриман|
URN|Ургун|Ургун|
URO|Руан|Руан|
URR|Уррао|Уррао|
URS|Курск|Курск|
URT|Сурат-Тхани|Сурат-Тхани|
URY|Гураят|Гураят|
URZ|Урузган|Урузган|
USH|Ушуайа|Ушуайа|
USI|Мабарума|Мабарума|
USK|Усинск|Усинск|
USM|Кох Самуи|Кох-Самуи|
USN|Ульсан|Ульсан|
USO|Усино|Усино|
USQ|Асак|Асак|
USS|Санкти-Спиритус|Санкти-Спиритус|
UST|Сент Огустин|Сент Огустин|
USU|Корон|Корон|
UTA|Мутаре|Мутаре|
UTC|Утрехт|Утрехт|
UTE|Баттерворт|Баттерворт|
UTH|Удон Тхани|Удон Тхани|
UTL|Торремолинос|Торремолинос|
UTN|Упингтон|Упингтон|
UTR|Уттарадит|Уттарадит|
UTT|Умтата|Умтата|
UTW|Куинстаун|Куинстаун|
UUA|Бугульма|Бугульма|
UUD|Мухино|Улан-Удэ|
UUS|Южно-Сахалинск|Южно-Сахалинск|
UUU|Мануму|Мануму|
UVO|Увол|Увол|
UYL|Ньяла|Ньяла|
UYN|Фулин|Фулин|
UZH|Унайза|Унайза|
UZU|Курусу-Куатья|Курусу-Куатья|
VAA|Васа|Васа|
VAB|Яварате|Яварате|
VAC|Варрельбух|Варрельбух|
VAF|Валенс|Валенс|
VAI|Ванимо|Ванимо|
VAN|Ван|Ван|
VAO|Суаванао|Суаванао|
VAP|Вальпараисо|Вальпараисо|
VAR|Варна|Варна|
VAS|Сивас|Сивас|
VAT|Ватомандри|Ватомандри|
VAU|Ватукула|Ватукула|
VBS|Бресия|Бресия|
VBV|Вануабалаву|Вануабалаву|
VBY|Висбю|Висби|
VCA|Кан-Тхо|Кан-Тхо|
VCE|Венеция|Венеция|
VCF|Вальчета|Вальчета|
VCH|Вичадеро|Вичадеро|
VCL|Тамки|Тамки|
VCR|Карора|Карора|
VCT|Лимбе|Лимбе|
VDA|Эйлат|Эйлат|
VDB|Фагернес|Фагернес|
VDD|Вена|Вена|
VDE|Хиерро|Валверде|
VDR|Вилья-Долорес|Вилья-Долорес|
VDS|Вадсо|Вадсо|
VEG|Маиквак|Маиквак|
VEJ|Вежле|Вежле|
VER|Веракруз|Веракруз|
VEV|Баракома|Баракома|
VEY|Вестменнейяр|Вестменнейяр|
VFA|Виктория-Фоллз|Водопады Виктории|
VGA|Виджаявада|Виджаявада|
VGD|Вологда|Вологда|
VGG|Вангренг|Вангренг|
VGO|Виго|Виго|
VGT|Лас Вегас|Лас Вегас|
VGZ|Виллагарсон|Виллагарсон|
VHC|Сауримо|Сауримо|
VHM|Вилхелмина|Вилхелмина|
VHY|Вичи|Вичи|
VHZ|Вахитахи|Вахитахи|
VIA|Вена|Вена|
VIB|Вилья-Конститусьон|Вилья-Конститусьон|
VIC|Виченца|Виченца|
VID|Видин|Видин|
VIE|Вена|Вена|
VIF|Виесте|Виесте|
VIG|Эль-Вигиа|Эль-Вигиа|
VIH|Вичи|Вичи|
VIN|Винница|Винница|
VIQ|Викеке|Викеке|
VIR|Дурбан|Дурбан|
VIU|Виру|Виру|
VIV|Вивигани|Вивигани|
VIX|Витория|Витория|
VIY|Париж|Париж|
VJI|Абингдон|Абингдон|
VKG|Рач-Дже|Рач-Дже|
VKO|Внуково|Москва|
VKS|Виксбург|Виксбург|
VKT|Воркута|Воркута|
VLC|Валенсия|Валенсия|
VLG|Вилья-Хесель|Вилья-Хесель|
VLI|Порт Вила|Порт Вила|
VLK|Волгодонск|Волгодонск|
VLL|Валладолид|Вальядолид|
VLN|Валенсия|Валенсия|
VLO|Валледжо, шт. Калифорния|Валледжо, шт. Калифорния|
VLP|Вила-Рика|Вила-Рика|
VLR|Вайенар|Вайенар|
VLS|Вейлсдир|Вейлсдир|
VLU|Великие Луки|Великие Луки|
VLV|Валера|Валера|
VME|Вилья-Мерседес|Вилья-Мерседес|
VMU|Беймуру|Беймуру|
VNA|Сараване|Сараване|
VNE|Ваннес|Ваннес|
VNO|Вильнюс|Вильнюс|
VNS|Варанаси|Варанаси|
VNT|Вентспилс|Вентспилс|
VNX|Виланкулос|Виланкулос|
VNY|Лос Анджелес|Лос Анджелес|
VOG|Волгоград|Волгоград|
VOH|Вохемар|Вохемар|
VOI|Войнджама|Войнджама|
VOL|Волос|Волос|
VOZ|Чертовицкое|Воронеж|
VPN|Вопнафьордур|Вопнафьордур|
VPZ|Вальпараисо|Вальпараисо|
VRA|Варадеро|Варадеро|
VRB|Веро Бич|Веро Бич|
VRC|Вирак|Вирак|
VRE|Вредендаль|Вредендаль|
VRK|Варкаус|Варкаус|
VRL|Вила Реаль|Вила-Реал|
VRN|Верона|Верона|
VRO|Матансас|Матансас|
VRS|Версаль|Версаль|
VRU|Врибург|Врибург|
VRY|Верой|Верой|
VSA|Вийяхермоса|Вийяхермоса|
VSE|Визеу|Визеу|
VSG|Луганск|Луганск|
VSO|Пхуоклонг|Пхуоклонг|
VST|Стокгольм|Стокгольм|
VTA|Виктория|Лимбе|
VTB|Восточный|Витебск|
VTE|Виентиане|Виентиане|
VTF|Ватулеле|Ватулеле|
VTL|Виттель|Виттель|
VTU|Лас Тунас|Лас-Тунас|
VTZ|Вишакхапатнам|Вишакхапатнам|
VUP|Валледупар|Валледупар|
VUS|Великий Устюг|Великий Устюг|
VVB|Маханору|Маханору|
VVI|Санта-Круз-Айленд|Санта-Круз-Айленд|
VVK|Вастервик|Вастервик|
VVO|Владивосток|Владивосток|
VVZ|Иллизи|Иллизи|
VXE|Сан-Педро|Сан-Педро|
VXO|Ваксьо|Ваксьо|
VYD|Врихейд|Врихейд|
VYS|Перу|Перу|
WAA|Уэльс|Уэльс|
WAB|Вабаг|Вабаг|
WAC|Вака|Вака|
WAD|Андриамена|Андриамена|
WAE|Вади-ад-Давасир|Вади-ад-Давасир|
WAF|Вана|Вана|
WAG|Вангануи|Вангануи|
WAI|Антсохиху|Антсохиху|
WAJ|Вавой-Фоллз|Вавой-Фоллз|
WAK|Анказоабо|Анказоабо|
WAM|Амбатондразака|Амбатондразака|
WAN|Вейверни|Вейверни|
WAO|Вабо|Вабо|
WAP|Альто-Палена|Альто-Палена|
WAQ|Антсалова|Антсалова|
WAR|Варис|Варис|
WAT|Уотерфорд|Вотерфорд|
WAW|Варшава|Варшава|
WBD|Бефандриана|Бефандриана|
WBE|Беаланана|Беаланана|
WBM|Вапенаманда|Вапенаманда|
WBO|Беророха|Беророха|
WCA|Гамбоа|Кастро|
WCH|Чайтен|Чайтен|
WDA|Вади-Эйн|Вади-Эйн|
WDI|Вондай|Вондай|
WED|Ведау|Ведау|
WEF|Вейфан|Вэйфан|
WEH|Вейхай|Вейхай|
WEL|Велком|Велком|
WEP|Вим|Вим|
WES|Висуа|Висуа|
WET|Вагете|Вагете|
WEX|Уэксфорд|Уэксфорд|
WFD|Вудфорд|Вудфорд|
WFI|Фианаранцоа|Фианаранцоа|
WGA|Вагга-Вагга|Вагга-Вагга|
WGB|Бахавалнагар|Бахавалнагар|
WGN|Вайтанги|Вайтанги|
WGP|Ваингапу|Ваингапу|
WGY|Вагни|Вагни|
WHF|Вади-Халфа|Вади-Халфа|
WHK|Вакатане|Вакатане|
WHO|Франц Йозеф|Франц-Джозеф|
WHP|Лос Анджелес|Лос Анджелес|
WHS|Волсей|Волсей|
WHU|Вуху|Вуху|
WIC|Вик|Вик|
WID|Вильденрат|Вильденрат|
WIE|Висбаден|Висбаден|
WIK|Сурфдейл|Сурфдейл|
WIL|Найроби|Найроби|
WIU|Виту|Виту|
WJA|Воджа|Воджа|
WJR|Ваджир|Ваджир|
WKA|Ванака|Ванака|
WKN|Вакунай|Вакунай|
WLA|Валлал|Валлал|
WLC|Валха|Валха|
WLG|Уеллингтон|Уеллингтон|
WLH|Валаха|Валаха|
WLL|Воллогорэнг|Воллогорэнг|
WLO|Ватерло|Ватерло|
WMA|Мандритсара|Мандритсара|
WMB|Варранамбул|Варранамбул|
WMD|Мандабе|Мандабе|
WML|Малаимбанди|Малаимбанди|
WMN|Мароантсера|Мароантсера|
WMP|Мампикони|Мампикони|
WMR|Мананара|Мананара|
WMV|Мадировало|Мадировало|
WMX|Вамена|Вамена|
WNE|Вора-На-Йе|Вора-На-Йе|
WNP|Нага|Нага|
WNU|Ванума|Ванума|
WNZ|Венчжоу|Венчжоу|
WOA|Воненара|Воненара|
WOE|Вонсдрехт|Вонсдрехт|
WOI|Вологисси|Вологисси|
WOK|Вонкен|Вонкен|
WOL|Воллонгонг|Воллонгонг|
WON|Вондула|Вондула|
WOT|Вонань|Вонань|
WPA|Пуэрто-Айсен|Пуэрто-Айсен|
WPB|Порт-Бердж|Порт-Бердж|
WPM|Випим|Випим|
WPR|Порвенир|Порвенир|
WPU|Пуэрто-Вильямс|Пуэрто-Вильямс|
WRA|Уордер|Уордер|
WRB|Макон|Макон|
WRE|Вангарей|Вангарей|
WRO|Вроцлав|Вроцлав|
WRY|Вестрей|Вестрей|
WSA|Васуа|Васуа|
WSJ|Сан Хуан|Сан Хуан|
WSO|Вашабо|Вашабо|
WSR|Васиор|Васиор|
WSU|Васу|Васу|
WSY|Эйрли Бич|Эйрли Бич|
WSZ|Уестпорт|Вестпорт|
WTA|Тамбохорано|Тамбохорано|
WTC|Нью-Йорк|Нью-Йорк|
WTD|Вест-Энд|Вест-Энд|
WTP|Войтапе|Войтапе|
WTS|Тсироаномандиди|Тсироаномандиди|
WTT|Вантоат|Вантоат|
WUG|Вау|Вау|
WUH|Вухан|Вухан|
WUS|Вуйшань|Вуйшань|
WUU|Вау|Вау|
WUX|Вуси|Вуси|
WUZ|Вучжоу|Вучжоу|
WVB|Волвис-Бей|Волвис-Бей|
WVK|Манакара|Манакара|
WVL|Уотервилл|Уотервилл|
WWK|Вевак|Вевак|
WYA|Вайалла|Вайалла|
WYE|Енгема|Енгема|
WYS|Йеллоустоун|Уест Йеллоустоун|
XAL|Алармос|Аламос|
XAR|Арибинда|Арибинда|
XAU|Саул|Саул|
XAY|Ксейабери|Ксейабери|
XBG|Боганд|Боганд|
XBJ|Бирджанд|Бирджанд|
XBL|Буно-Беделле|Буно-Беделле|
XBN|Бинигуни|Бинигуни|
XBO|Булса|Булса|
XDB|Лилль|Лилль|
XDE|Диебугу|Диебугу|
XDJ|Джибо|Джибо|
XDT|Париж|Париж|
XDV|Принс Джордж|Принс Джордж|
XDW|Принц Руперт|Принц Руперт|
XEA|Ванкувер|Ванкувер|
XEN|Хайньчен|Хайньчен|
XEX|Париж|Париж|
XFA|Лилль|Лилль|
XFN|Сянфань|Сянфань|
XFW|Гамбург|Гамбург|
XFY|Квебек|Квебек|
XFZ|Квебек|Квебек|
XGA|Гауа|Гауа|
XGB|Париж|Париж|
XGN|Шангонго|Шангонго|
XHN|Льеж|Льеж|
XHX|Аделаида|Аделаида|
XIC|Хайчэн|Хайчэн|
XIE|Ксьенглом|Ксьенглом|
XIG|Шингуэра|Шингуэра|
XIK|Милан|Милан|
XIL|Хайлиньхот|Хайлиньхот|
XIN|Хайньнин|Хайньнин|
XIX|Верона|Верона|
XIY|Синьян|Синьян|
XKA|Канчари|Канчари|
XKC|Сенднес|Сенднес|
XKH|Ксьенг-Кхуанг|Ксьенг-Кхуанг|
XKY|Кайя|Кайя|
XLJ|Квебек|Квебек|
XLM|Монреаль|Монреаль|
XLO|Лонь-Йен|Лонь-Йен|
XLS|Сент Луис|Сент Луис|
XLU|Лео|Лео|
XMG|Махендранагар|Махендранагар|
XMH|Манихи|Манихи|
XMI|Масаси|Масаси|
XMN|Хаймень|Сямэнь|
XMS|Макас|Макас|
XNG|Кванг-Нгаи|Кванг-Нгаи|
XNN|Хайнин|Хайнин|
XNT|Хайнтай|Хайнтай|
XOZ|Доха|Доха|
XPA|Пама|Пама|
XPG|Париж|Париж|
XPL|Комаягуа|Комаягуа|
XPQ|Порт Кланг|Порт Кланг|
XQP|Куэпос|Куэпос|
XRH|Ричмонд|Ричмонд|
XRJ|Рим|Рим|
XSA|Синоу|Синоу|
XSD|Тонопа|Тонопа|
XSE|Себба|Себба|
XSP|Сингапур|Сингапур|
XTA|Тяньцзинь|Тяньцзинь|
XTF|Тяньцзинь|Тяньцзинь|
XTO|Тарум|Тарум|
XTT|Париж|Париж|
XUZ|Сучжоу|Хучжоу|
XVL|Винь-Лонь|Винь-Лонь|
XVQ|Венеция|Венеция|
XVY|Рим|Рим|
XWC|Вена|Вена|
XWK|Роннеби|Роннеби|
XWL|Готенбург|Готенбург|
XWQ|Енкопинг|Енкопинг|
XWW|Вена|Вена|
XWZ|Никопинг|Никопинг|
XYD|Лион|Лион|
XYE|Йе|Йе|
XYL|Лион|Лион|
XYO|Карлсхамн|Карлсхамн|
XYT|Тулуз|Тулуз|
XYV|Лион|Лион|
XZA|Забре|Забре|
XZF|Дамман|Дамман|
YAI|Чийан|Чиллан|
YAM|Со Сен Мари|Со Сен Мари|
YAN|Янгамби|Янгамби|
YAO|Яунде|Яунде|
YAW|Галифакс|Галифакс|
YBA|Банфф|Банфф|
YBL|Кэмпбелл Ривер|Кэмпбелл Ривер|
YBP|Ибин|Ибин|
YBR|Брэндон|Брэндон|
YBW|Калгари|Калгари|
YCD|Нанаимо|Нанаимо|
YCN|Кочране|Кочране|
YCW|Чиллиуок|Чиллиуок|
YDT|Ванкувер|Ванкувер|
YDX|Док-Крик|Док-Крик|
YED|Едмонтон|Едмонтон|
YEI|Бурса|Бурса|
YEO|Йовилтон|Йовилтон|
YEQ|Енкис|Енкис|
YFC|Фредериктон|Фредериктон|
YGJ|Йонаго|Йонаго|
YGK|Кингстон|Кингстоун|
YHC|Хакаи-Пасс|Хакаи-Пасс|
YHD|Драйден|Драйден|
YHH|Кэмпбелл Ривер|Кэмпбелл Ривер|
YHM|Гамильтон|Гамильтон|
YHU|Монреаль|Монреаль|
YHZ|Галифакс|Галифакс|
YIH|Фучэн|Фучэн|
YIN|Фунин|Иньин|
YIW|Иву|Иву|
YKA|Камлупс|Камлупс|
YKM|Якима|Якима|
YKS|Якутск|Якутск|
YKZ|Торонто|Торонто|
YLN|Фулан|Фулан|
YML|Шарлевуа|Шарлевуа|
YMS|Юримагуас|Юримагуас|
YMX|Монреаль|Монреаль|
YNB|Янбу|Янбу|
YND|Оттава|Оттава|
YNJ|Фаньчжы|Яньцзи|
YNT|Фантай|Янтай|
YNY|Янян|Янян|
YNZ|Яньчэн|Яньчэн|
YOK|Йокогама|Йокогама|
YOL|Йола|Йола|
YOS|Оуэн Саунд|Оуэн Саунд|
YOW|Оттава|Оттава|
YPI|Порт Симпсон|Порт Симпсон|
YPR|Принц Руперт|Принц Руперт|
YQE|Кимберли|Кимберли|
YQG|Виндзор|Виндзор|
YQL|Летбридж|Летбридж|
YQR|Регина|Регина|
YQT|Тандер Бэй|Тандер Бэй|
YQV|Йорктон|Йорктон|
YQY|Сидней|Сидней|
YQZ|Кеснел|Кеснел|
YRO|Оттава|Оттава|
YRV|Ревелстоук|Ревелстоук|
YSJ|Сент Джон|Сент Джон|
YSP|Марафон|Марафон|
YTF|Альма|Альма|
YTK|Тулугак|Тулугак|
YTM|Мон Тремблан|Мон Тремблан|
YTO|Торонто|Торонто|
YTU|Тасу|Тасу|
YTZ|Торонто|Торонто|
YUL|Монреаль|Монреаль|
YVD|Ева|Ева|
YWF|Галифакс|Галифакс|
YWG|Виннипег|Виннипег|
YWH|Лимбе|Лимбе|
YWS|Уистлер|Уистлер|
YXD|Едмонтон|Едмонтон|
YXE|Саскатун|Саскатун|
YXH|Медисин Хет|Медисин Хет|
YXS|Принс Джордж|Принс Джордж|
YYB|Норт Бэй|Норт Бэй|
YYF|Пентинктон|Пентинктон|
YYJ|Лимбе|Лимбе|
YYZ|Торонто|Торонто|
ZAD|Задар|Задар|
ZAG|Загреб|Загреб|
ZAH|Захедан|Захедан|
ZAJ|Зарандж|Зарандж|
ZAL|Вальдивия|Вальдивия|
ZAO|Каор|Каор|
ZAR|Зариа|Зариа|
ZAS|Шанде|Шанде|
ZAT|Жаньтон|Жаньтон|
ZAZ|Сарагоса|Сарагоса|
ZBE|Забржег|Забржег|
ZBF|Батерст|Батерст|
ZBK|Завлака|Завлака|
ZBP|Балтимор|Балтимор|
ZBY|Сайабори|Сайабори|
ZCL|Закатекас|Закатекас|
ZCO|Темуко|Темуко|
ZCP|Фошан|Фошан|
ZDU|Данди|Данди|
ZEG|Сенгго|Сенгго|
ZER|Зеро|Зеро|
ZFA|Фаро|Фаро|
ZFJ|Ренн|Ренн|
ZFQ|Бордо|Бордо|
ZGC|Ланчжоу|Ланчжоу|
ZGL|Сауз-Галвей|Сауз-Галвей|
ZGM|Нгома|Нгома|
ZGN|Чжуншань|Чжуншань|
ZGY|Кучинг|Кучинг|
ZHA|Жаньчжан|Чжаньчзян|
ZHC|Филадельфия|Филадельфия|
ZHM|Шамшернагар|Шамшернагар|
ZIC|Виктория|Лимбе|
ZIG|Зигунчор|Зигунчор|
ZIH|Ихтапа-Сихуатанех|Ихтапа-Сихуатанех|
ZJB|Куантан|Куантан|
ZJR|Пенанг|Пенанг|
ZJY|Понза|Понза|
ZKB|Касаба-Бей|Касаба-Бей|
ZKL|Стеенкоол|Стеенкоол|
ZKM|Сетте-Кама|Сетте-Кама|
ZLG|Эль-Гуэра|Эль-Гуэра|
ZLO|Манзанилло|Манзанилло|
ZLX|Лондон|Лондон|
ZMF|Неаполь|Неаполь|
ZMJ|Неаполь|Неаполь|
ZMK|Бинтулу|Бинтулу|
ZMM|Замора|Замора|
ZNA|Нанаимо|Нанаимо|
ZND|Зиндер|Зиндер|
ZNE|Ньюмен|Ньюмен|
ZNU|Наму|Наму|
ZOS|Осорно|Осорно|
ZPC|Пукон|Пукон|
ZQN|Куинстаун|Куинстаун|
ZRD|Ричмонд|Ричмонд|
ZRF|Рокфорд|Рокфорд|
ZRH|Цюрих|Цюрих|
ZRI|Серуи|Серуи|
ZRK|Рокфорд|Рокфорд|
ZRT|Хартфорд|Хартфорд|
ZRU|Бостон|Бостон|
ZRV|Провиденс|Провиденс|
ZSA|Сан-Сальвадор|Сан-Сальвадор|
ZSP|Сен Поль|Сен Поль|
ZSW|Принц Руперт|Принц Руперт|
ZTE|Рочестер|Рочестер|
ZTN|Филадельфия|Филадельфия|
ZTO|Бостон|Бостон|
ZTR|Житомир|Житомир|
ZTY|Бостон|Бостон|
ZUD|Анкуд|Анкуд|
ZUH|Чжухай|Чжухай|
ZUL|Зилфи|Зилфи|
ZVA|Миандривацо|Миандривацо|
ZVK|Сваннакхэт|Сваннакхэт|
ZWA|Андапа|Андапа|
ZWR|Кота Кинабалу|Кота Кинабалу|
ZXP|Перт|Перт|
ZYD|Лиссабон|Лиссабон|
ZYF|Фаро|Фаро|
ZYH|Гаага|Гаага|
ZYI|Цунии|Цунии|
ZYQ|Сиракус|Сиракус|
ZZU|Мзузу|Мзузу|
ZZV|Занесвилл|Занесвилл|